Date,Description,Withdrawal,Deposit,Balance,Week,Month,Year,Category
2022-02-07,BEST BUY #634     _F,0.0,20.65,78.36,6,2,2022,Interest
2022-02-07,THE E JUICE GAL   _F,16.93,0.0,61.43,6,2,2022,Bills
2022-02-14,PIZZA PIZZA # 6   _F,5.07,0.0,56.36,7,2,2022,Food
2022-02-16,CANADA           PAY,0.0,458.56,514.92,7,2,2022,Bonus
2022-02-16,WATERSHED 144     _F,4.24,0.0,510.68,7,2,2022,Groceries
2022-02-16,SEND E-TFR ***4sU   ,12.0,0.0,498.68,7,2,2022,Entertainment
2022-02-16,SKIPTHEDISHES     _V,32.94,0.0,465.74,7,2,2022,Entertainment
2022-02-17,PIZZA PIZZA LTD   _V,25.24,0.0,440.5,7,2,2022,Food
2022-02-17,SKIPTHEDISHES     _V,22.99,0.0,417.51,7,2,2022,Transportation
2022-02-17,SKIPTHEDISHES     _V,17.84,0.0,399.67,7,2,2022,Entertainment
2022-02-18,SKIPTHEDISHES     _V,32.94,0.0,366.73,7,2,2022,Shopping
2022-02-18,SKIPTHEDISHES     _V,10.69,0.0,356.04,7,2,2022,Bills
2022-02-22,SKIPTHEDISHES     _V,21.29,0.0,334.75,8,2,2022,Entertainment
2022-02-28,SKIPTHEDISHES     _V,32.94,0.0,301.81,9,2,2022,Other
2022-02-28,SKIPTHEDISHES     _V,23.34,0.0,278.47,9,2,2022,Food
2022-02-28,SEND E-TFR ***Rys   ,100.0,0.0,178.47,9,2,2022,Bills
2022-02-28,PIZZA PIZZA # 6     ,24.21,0.0,154.26,9,2,2022,Transportation
2022-03-01,SKIPTHEDISHES     _V,35.5,0.0,118.76,9,3,2022,Groceries
2022-03-02,CANADA           PAY,0.0,571.29,690.05,9,3,2022,Salary
2022-03-02,SKIPTHEDISHES     _V,29.45,0.0,660.6,9,3,2022,Entertainment
2022-03-02,SKIPTHEDISHES     _V,8.6,0.0,652.0,9,3,2022,Bills
2022-03-03,E-TRANSFER ***Stb   ,0.0,300.0,952.0,9,3,2022,Other
2022-03-03,LRNTN UNIV   U6X6L8 ,300.0,0.0,652.0,9,3,2022,Travel
2022-03-03,JUICE ON THE LO   _F,18.07,0.0,633.93,9,3,2022,Transportation
2022-03-03,CANNA CABANA        ,104.05,0.0,529.88,9,3,2022,Bills
2022-03-03,MCDONALD'S #311   _F,14.89,0.0,514.99,9,3,2022,Entertainment
2022-03-03,SKIPTHEDISHES     _V,22.55,0.0,492.44,9,3,2022,Groceries
2022-03-04,SKIPTHEDISHES     _V,29.45,0.0,462.99,9,3,2022,Other
2022-03-04,LRNTN UNIV   W2H9H6 ,53.21,0.0,409.78,9,3,2022,Travel
2022-03-07,SKIPTHEDISHES     _V,29.45,0.0,380.33,10,3,2022,Bills
2022-03-07,SKIPTHEDISHES     _V,19.05,0.0,361.28,10,3,2022,Entertainment
2022-03-07,SKIPTHEDISHES     _V,29.45,0.0,331.83,10,3,2022,Food
2022-03-07,SKIPTHEDISHES     _V,22.57,0.0,309.26,10,3,2022,Other
2022-03-07,SKIPTHEDISHES     _V,22.55,0.0,286.71,10,3,2022,Shopping
2022-03-07,SEND E-TFR ***6eC   ,28.2,0.0,258.51,10,3,2022,Bills
2022-03-08,SEND E-TFR ***hdn   ,9.5,0.0,249.01,10,3,2022,Groceries
2022-03-08,SKIPTHEDISHES     _V,22.55,0.0,226.46,10,3,2022,Travel
2022-03-09,NON-TD ATM W/D      ,123.0,0.0,103.46,10,3,2022,Other
2022-03-09,LCBO/RAO #0287    _F,22.55,0.0,80.91,10,3,2022,Travel
2022-03-10,SKIPTHEDISHES     _V,29.45,0.0,51.46,10,3,2022,Groceries
2022-03-10,CANNA CABANA      _F,33.55,0.0,17.91,10,3,2022,Travel
2022-03-10,E-TRANSFER ***rF2   ,0.0,70.0,87.91,10,3,2022,Interest
2022-03-11,SKIPTHEDISHES     _V,29.45,0.0,58.46,10,3,2022,Shopping
2022-03-14,SKIPTHEDISHES     _V,29.45,0.0,29.01,11,3,2022,Entertainment
2022-03-14,SKIPTHEDISHES     _V,18.05,0.0,10.96,11,3,2022,Groceries
2022-03-16,CANADA           PAY,0.0,571.29,582.25,11,3,2022,Other
2022-03-16,SKIPTHEDISHES     _V,29.45,0.0,552.8,11,3,2022,Groceries
2022-03-16,SKIPTHEDISHES     _V,17.05,0.0,535.75,11,3,2022,Transportation
2022-03-17,SKIPTHEDISHES     _V,12.4,0.0,523.35,11,3,2022,Travel
2022-03-17,DD                _V,19.58,0.0,503.77,11,3,2022,Entertainment
2022-03-17,SKIPTHEDISHES     _V,17.05,0.0,486.72,11,3,2022,Shopping
2022-03-18,SKIPTHEDISHES     _V,32.5,0.0,454.22,11,3,2022,Food
2022-03-21,DD                _V,18.39,0.0,435.83,12,3,2022,Bills
2022-03-21,SKIPTHEDISHES     _V,24.45,0.0,411.38,12,3,2022,Shopping
2022-03-21,AIRBNB * H  375.98_V,375.98,0.0,35.4,12,3,2022,Travel
2022-03-21,E-TRANSFER ***FYC   ,0.0,50.0,85.4,12,3,2022,Bonus
2022-03-21,SKIPTHEDISHES     _V,31.79,0.0,53.61,12,3,2022,Bills
2022-03-21,SKIPTHEDISHES     _V,29.45,0.0,24.16,12,3,2022,Other
2022-03-21,CANNA CABANA      _F,22.36,0.0,1.8,12,3,2022,Food
2022-03-22,E-TRANSFER ***Jhr   ,0.0,150.0,151.8,12,3,2022,Bonus
2022-03-22,SKIPTHEDISHES     _V,29.45,0.0,122.35,12,3,2022,Transportation
2022-03-23,SKIPTHEDISHES     _V,22.55,0.0,99.8,12,3,2022,Travel
2022-03-24,SKIPTHEDISHES     _V,22.55,0.0,77.25,12,3,2022,Groceries
2022-03-25,E-TRANSFER ***jeg   ,0.0,500.0,577.25,12,3,2022,Other
2022-03-25,SKIPTHEDISHES     _V,29.45,0.0,547.8,12,3,2022,Groceries
2022-03-28,LAURENTIAN UNIV   _V,2.0,0.0,545.8,13,3,2022,Entertainment
2022-03-28,THAI EXPRESS      _M,34.42,0.0,511.38,13,3,2022,Shopping
2022-03-28,NYX ECIGS BATHU   _F,21.46,0.0,489.92,13,3,2022,Travel
2022-03-28,SQ *FONDA BALAM   _M,46.67,0.0,443.25,13,3,2022,Other
2022-03-28,UBER CANADA       _V,11.46,0.0,431.79,13,3,2022,Food
2022-03-28,NON-TD ATM W/D      ,42.99,0.0,388.8,13,3,2022,Shopping
2022-03-28,UBER* PENDING     _V,27.35,0.0,361.45,13,3,2022,Other
2022-03-28,UBER CANADA       _V,15.77,0.0,345.68,13,3,2022,Transportation
2022-03-28,E-TRANSFER ***EPw   ,0.0,50.0,395.68,13,3,2022,Interest
2022-03-28,SQ *FRONT LINEZ   _V,30.2,0.0,365.48,13,3,2022,Entertainment
2022-03-28,SQ *FRONT LINEZ   _F,25.99,0.0,339.49,13,3,2022,Bills
2022-03-28,LCBO/RAO #0015    _F,35.9,0.0,303.59,13,3,2022,Food
2022-03-29,UBER CANADA       _V,13.2,0.0,290.39,13,3,2022,Travel
2022-03-29,DALDONGNAE #4     _F,49.94,0.0,240.45,13,3,2022,Entertainment
2022-03-29,SKIPTHEDISHES     _V,36.72,0.0,203.73,13,3,2022,Bills
2022-03-29,UBER* TR REV 03/28_V,0.0,27.35,231.08,13,3,2022,Interest
2022-03-29,UBER* TRIP        _V,25.98,0.0,205.1,13,3,2022,Groceries
2022-03-29,CHUBBYS JAMAICA   _F,78.11,0.0,126.99,13,3,2022,Shopping
2022-03-30,WINE RACK 330     _F,22.55,0.0,104.44,13,3,2022,Groceries
2022-03-30,CANADA           PAY,0.0,571.29,675.73,13,3,2022,Other
2022-03-30,FOGTOWN FLOWER      ,40.68,0.0,635.05,13,3,2022,Entertainment
2022-03-30,RACHELS COFFEE    _F,17.0,0.0,618.05,13,3,2022,Transportation
2022-03-30,KINGKONG TTEOKB   _F,40.25,0.0,577.8,13,3,2022,Shopping
2022-03-30,TRESTLE BREWING   _F,42.68,0.0,535.12,13,3,2022,Food
2022-03-30,SUNRISE INN - P   _F,120.7,0.0,414.42,13,3,2022,Shopping
2022-03-31,JUICE ON THE LO   _F,16.94,0.0,397.48,13,3,2022,Food
2022-03-31,SUKHDEV RESTAUR     ,27.07,0.0,370.41,13,3,2022,Transportation
2022-03-31,WITHDRAWAL FEES     ,48.75,0.0,321.66,13,3,2022,Shopping
2022-03-31,OTHER BANK FEES     ,4.0,0.0,317.66,13,3,2022,Entertainment
2022-04-01,CANNA CABANA      _F,32.53,0.0,285.13,13,4,2022,Shopping
2022-04-01,WINE RACK 169     _F,22.55,0.0,262.58,13,4,2022,Travel
2022-04-04,NON-TD ATM W/D      ,64.0,0.0,198.58,14,4,2022,Groceries
2022-04-04,LCBO/RAO #0407    _F,48.2,0.0,150.38,14,4,2022,Groceries
2022-04-05,CANADA           GST,0.0,74.75,225.13,14,4,2022,Salary
2022-04-05,SKIPTHEDISHES     _V,26.1,0.0,199.03,14,4,2022,Groceries
2022-04-06,JUICE ON THE LO   _F,33.88,0.0,165.15,14,4,2022,Entertainment
2022-04-06,SKIPTHEDISHES     _V,22.55,0.0,142.6,14,4,2022,Transportation
2022-04-06,SKIPTHEDISHES     _V,10.58,0.0,132.02,14,4,2022,Food
2022-04-06,SEND E-TFR ***uAX   ,8.5,0.0,123.52,14,4,2022,Groceries
2022-04-07,SKIPTHEDISHES     _V,26.1,0.0,97.42,14,4,2022,Bills
2022-04-07,WINE RACK 169     _F,42.6,0.0,54.82,14,4,2022,Entertainment
2022-04-11,SKIPTHEDISHES     _V,22.55,0.0,32.27,15,4,2022,Entertainment
2022-04-11,NON-TD ATM W/D      ,23.75,0.0,8.52,15,4,2022,Groceries
2022-04-13,CANADA           PAY,0.0,571.29,579.81,15,4,2022,Interest
2022-04-13,WINE RACK 169     _F,22.55,0.0,557.26,15,4,2022,Transportation
2022-04-13,CANNA CABANA      _M,32.53,0.0,524.73,15,4,2022,Other
2022-04-14,LRNTN UNIV   W6K3K7 ,500.0,0.0,24.73,15,4,2022,Shopping
2022-04-14,SKIPTHEDISHES     _V,22.55,0.0,2.18,15,4,2022,Transportation
2022-04-27,CANADA           PAY,0.0,571.29,573.47,17,4,2022,Salary
2022-04-27,URIDE             _V,19.22,0.0,554.25,17,4,2022,Other
2022-04-27,URIDE             _V,0.39,0.0,553.86,17,4,2022,Transportation
2022-04-27,MCDONALD'S #311   _M,7.67,0.0,546.19,17,4,2022,Shopping
2022-04-27,CANNA CABANA      _F,34.34,0.0,511.85,17,4,2022,Food
2022-04-27,JUICE ON THE LO   _F,20.33,0.0,491.52,17,4,2022,Food
2022-04-27,URIDE             _V,18.85,0.0,472.67,17,4,2022,Bills
2022-04-27,URIDE             _V,0.15,0.0,472.52,17,4,2022,Transportation
2022-04-27,SKIPTHEDISHES     _V,24.15,0.0,448.37,17,4,2022,Transportation
2022-04-27,LICKS HOMEBURGE   _F,18.62,0.0,429.75,17,4,2022,Other
2022-04-29,Sony Inter   24.17_V,24.17,0.0,405.58,17,4,2022,Entertainment
2022-04-29,SOBEYS #865         ,20.29,0.0,385.29,17,4,2022,Entertainment
2022-04-29,WITHDRAWAL FEES     ,3.75,0.0,381.54,17,4,2022,Food
2022-04-29,OTHER BANK FEES     ,4.0,0.0,377.54,17,4,2022,Bills
2022-05-02,PEARL CONVENIEN   _F,22.6,0.0,354.94,18,5,2022,Transportation
2022-05-02,PIZZA DEPOT BRA   _F,5.75,0.0,349.19,18,5,2022,Bills
2022-05-02,CANNABIS XPRESS   _F,39.54,0.0,309.65,18,5,2022,Food
2022-05-03,SOBEYS #865       _F,10.64,0.0,299.01,18,5,2022,Transportation
2022-05-03,THE INDIAN STRE   _F,1.7,0.0,297.31,18,5,2022,Groceries
2022-05-05,SOBEYS #865       _F,33.01,0.0,264.3,18,5,2022,Travel
2022-05-05,DAISY MART        _F,20.33,0.0,243.97,18,5,2022,Groceries
2022-05-05,KFC/TACO BELL     _F,10.95,0.0,233.02,18,5,2022,Other
2022-05-05,SOBEYS #865       _F,3.4,0.0,229.62,18,5,2022,Bills
2022-05-06,SOBEYS #865         ,3.4,0.0,226.22,18,5,2022,Transportation
2022-05-06,SOBEYS #865       _F,17.75,0.0,208.47,18,5,2022,Groceries
2022-05-06,RICK'S KITCHEN    _F,7.32,0.0,201.15,18,5,2022,Bills
2022-05-06,BOAR N WING SPO   _M,38.13,0.0,163.02,18,5,2022,Shopping
2022-05-09,DAISY MART        _F,11.3,0.0,151.72,19,5,2022,Groceries
2022-05-09,CANNABIS XPRESS   _F,39.54,0.0,112.18,19,5,2022,Groceries
2022-05-09,AVO CONVENIENCE   _F,14.99,0.0,97.19,19,5,2022,Other
2022-05-09,SOBEYS #865       _F,18.59,0.0,78.6,19,5,2022,Travel
2022-05-09,SOBEYS #865       _M,1.13,0.0,77.47,19,5,2022,Other
2022-05-09,ONLYFANS.C    9.04_V,12.09,0.0,65.38,19,5,2022,Other
2022-05-09,PEARL CONVENIEN   _F,22.6,0.0,42.78,19,5,2022,Travel
2022-05-09,SOBEYS #865       _M,21.5,0.0,21.28,19,5,2022,Other
2022-05-10,LCBO/RAO #470     _F,18.45,0.0,2.83,19,5,2022,Bills
2022-05-11,CANADA           PAY,0.0,364.07,366.9,19,5,2022,Other
2022-05-12,CANNABIS XPRESS   _M,37.28,0.0,329.62,19,5,2022,Food
2022-05-12,CITY SOUTH PIZZ   _M,4.86,0.0,324.76,19,5,2022,Food
2022-05-12,ONLYFANS.C   14.13_V,19.13,0.0,305.63,19,5,2022,Transportation
2022-05-13,THE INDIAN STRE   _F,7.9,0.0,297.73,19,5,2022,Other
2022-05-13,SOBEYS #865         ,23.35,0.0,274.38,19,5,2022,Transportation
2022-05-16,LICKS HOMEBURGE   _M,19.2,0.0,255.18,20,5,2022,Entertainment
2022-05-16,SKIPTHEDISHES     _V,26.1,0.0,229.08,20,5,2022,Food
2022-05-16,SH VENDING80036   _M,1.9,0.0,227.18,20,5,2022,Entertainment
2022-05-16,SH VENDING80036   _M,3.65,0.0,223.53,20,5,2022,Other
2022-05-16,LOCKERBY TRANSP   _M,40.25,0.0,183.28,20,5,2022,Travel
2022-05-16,TIM HORTONS #30   _M,8.99,0.0,174.29,20,5,2022,Shopping
2022-05-16,P.B. YORKDALE     _M,39.09,0.0,135.2,20,5,2022,Food
2022-05-16,PEARL CONVENIEN   _F,22.6,0.0,112.6,20,5,2022,Travel
2022-05-16,THE INDIAN STRE   _M,7.9,0.0,104.7,20,5,2022,Food
2022-05-16,CANNABIS XPRESS   _F,40.67,0.0,64.03,20,5,2022,Travel
2022-05-18,SOBEYS #865       _M,13.95,0.0,50.08,20,5,2022,Groceries
2022-05-18,SOBEYS #865       _M,4.69,0.0,45.39,20,5,2022,Travel
2022-05-19,PEARL CONVENIEN   _M,22.6,0.0,22.79,20,5,2022,Other
2022-05-19,LCBO/RAO #0171    _F,3.1,0.0,19.69,20,5,2022,Groceries
2022-05-24,SKIPTHEDISHES     _V,17.75,0.0,1.94,21,5,2022,Other
2022-05-25,CANADA           PAY,0.0,61.59,63.53,21,5,2022,Interest
2022-05-25,CANADA           PAY,0.0,978.51,1042.04,21,5,2022,Salary
2022-05-25,SEND E-TFR ***TTr   ,400.0,0.0,642.04,21,5,2022,Travel
2022-05-25,SKIPTHEDISHES     _V,22.55,0.0,619.49,21,5,2022,Food
2022-05-25,SHOPPERS DRUG M   _F,85.08,0.0,534.41,21,5,2022,Transportation
2022-05-25,ROSE APPLE ASIA     ,80.6,0.0,453.81,21,5,2022,Food
2022-05-25,CANNA CABANA      _F,6.43,0.0,447.38,21,5,2022,Food
2022-05-27,HIGHLIFE SUDBUR   _F,1.13,0.0,446.25,21,5,2022,Entertainment
2022-05-27,FAMOUS PLAYER #   _F,24.37,0.0,421.88,21,5,2022,Other
2022-05-27,SHOPPERS DRUG M   _F,62.85,0.0,359.03,21,5,2022,Bills
2022-05-27,CANNA CABANA      _F,53.57,0.0,305.46,21,5,2022,Groceries
2022-05-30,POPEYES #13854    _M,19.75,0.0,285.71,22,5,2022,Other
2022-05-30,LCBO/RAO #0050    _M,15.45,0.0,270.26,22,5,2022,Bills
2022-05-30,JUICE ON THE LO   _F,20.33,0.0,249.93,22,5,2022,Transportation
2022-05-30,THAI EXPRESS      _M,30.13,0.0,219.8,22,5,2022,Bills
2022-05-31,SHOPPERS DRUG M   _M,5.57,0.0,214.23,22,5,2022,Transportation
2022-05-31,CANNA CABANA        ,34.06,0.0,180.17,22,5,2022,Bills
2022-05-31,REHAN'S YIG #16   _F,53.58,0.0,126.59,22,5,2022,Entertainment
2022-05-31,POPEYES #13854    _F,16.93,0.0,109.66,22,5,2022,Shopping
2022-06-01,SKIPTHEDISHES     _V,22.55,0.0,87.11,22,6,2022,Travel
2022-06-02,SKIPTHEDISHES     _V,22.55,0.0,64.56,22,6,2022,Groceries
2022-06-03,NON-TD ATM W/D      ,43.0,0.0,21.56,22,6,2022,Other
2022-06-03,SH VENDING80036   _M,2.65,0.0,18.91,22,6,2022,Entertainment
2022-06-03,SKIPTHEDISHES     _V,18.35,0.0,0.56,22,6,2022,Entertainment
2022-06-07,E-TRANSFER ***QEY   ,0.0,40.0,40.56,23,6,2022,Interest
2022-06-07,TD ATM W/D    004914,40.0,0.0,0.56,23,6,2022,Entertainment
2022-06-08,CANADA           PAY,0.0,1083.97,1084.53,23,6,2022,Bonus
2022-06-08,SKIPTHEDISHES     _V,22.55,0.0,1061.98,23,6,2022,Shopping
2022-06-08,URIDE             _V,25.86,0.0,1036.12,23,6,2022,Other
2022-06-08,JUICE ON THE LO   _F,22.59,0.0,1013.53,23,6,2022,Groceries
2022-06-08,MCDONALD'S #311   _F,11.97,0.0,1001.56,23,6,2022,Groceries
2022-06-08,URIDE             _V,24.79,0.0,976.77,23,6,2022,Other
2022-06-08,THE BEER STORE    _F,3.1,0.0,973.67,23,6,2022,Groceries
2022-06-09,URIDE    REV 06/08_V,0.0,25.86,999.53,23,6,2022,Interest
2022-06-09,URIDE             _V,22.96,0.0,976.57,23,6,2022,Other
2022-06-09,URIDE    REV 06/08_V,0.0,24.79,1001.36,23,6,2022,Bonus
2022-06-09,URIDE             _V,19.15,0.0,982.21,23,6,2022,Entertainment
2022-06-09,E-TRANSFER ***K4C   ,0.0,3000.0,3982.21,23,6,2022,Other
2022-06-09,LRNTN UNIV   H2X6K6 ,3000.0,0.0,982.21,23,6,2022,Other
2022-06-09,SKIPTHEDISHES     _V,17.55,0.0,964.66,23,6,2022,Other
2022-06-09,SKIPTHEDISHES     _V,16.55,0.0,948.11,23,6,2022,Other
2022-06-10,E-TRANSFER ***F6n   ,0.0,3000.0,3948.11,23,6,2022,Bonus
2022-06-10,LRNTN UNIV   H5X2A4 ,2500.0,0.0,1448.11,23,6,2022,Other
2022-06-10,SKIPTHEDISHES     _V,22.55,0.0,1425.56,23,6,2022,Transportation
2022-06-10,LRNTN UNIV   H5Y2L8 ,245.0,0.0,1180.56,23,6,2022,Transportation
2022-06-10,SKIPTHEDISHES     _V,41.29,0.0,1139.27,23,6,2022,Other
2022-06-10,CANNA CABANA      _F,33.27,0.0,1106.0,23,6,2022,Groceries
2022-06-13,GIANT TIGER # 2   _F,110.01,0.0,995.99,24,6,2022,Travel
2022-06-13,REHAN'S YIG #16     ,120.08,0.0,875.91,24,6,2022,Transportation
2022-06-13,WINE RACK 169     _F,15.45,0.0,860.46,24,6,2022,Food
2022-06-13,JUICE ON THE LO   _F,18.07,0.0,842.39,24,6,2022,Shopping
2022-06-13,CANNA CABANA      _F,42.53,0.0,799.86,24,6,2022,Shopping
2022-06-13,FOOD BASICS  63     ,30.24,0.0,769.62,24,6,2022,Food
2022-06-13,SH VENDING80036   _M,2.65,0.0,766.97,24,6,2022,Groceries
2022-06-14,POPEYES #13854    _F,19.75,0.0,747.22,24,6,2022,Groceries
2022-06-14,HIGHLIFE SUDBUR   _F,28.24,0.0,718.98,24,6,2022,Other
2022-06-15,SKIPTHEDISHES     _V,22.55,0.0,696.43,24,6,2022,Transportation
2022-06-15,SKIPTHEDISHES     _V,22.55,0.0,673.88,24,6,2022,Travel
2022-06-15,SKIPTHEDISHES     _V,0.0,22.55,696.43,24,6,2022,Other
2022-06-16,SKIPTHEDISHES     _V,22.55,0.0,673.88,24,6,2022,Travel
2022-06-17,SKIPTHEDISHES     _V,21.6,0.0,652.28,24,6,2022,Other
2022-06-17,TIM HORTONS #10   _M,4.19,0.0,648.09,24,6,2022,Transportation
2022-06-20,PEARL CONVENIEN   _M,22.6,0.0,625.49,25,6,2022,Shopping
2022-06-20,CONVENIENCE S     _M,16.0,0.0,609.49,25,6,2022,Transportation
2022-06-20,CANNABIS XPRESS   _F,38.41,0.0,571.08,25,6,2022,Bills
2022-06-20,LRNTN UNIV   L5H5L2 ,362.55,0.0,208.53,25,6,2022,Entertainment
2022-06-21,TD ATM W/D    000423,50.0,0.0,158.53,25,6,2022,Food
2022-06-21,SOBEYS #865       _F,21.44,0.0,137.09,25,6,2022,Travel
2022-06-22,CANADA           PAY,0.0,1083.96,1221.05,25,6,2022,Interest
2022-06-22,MCDONALD'S #291   _F,13.89,0.0,1207.16,25,6,2022,Transportation
2022-06-23,AMZN Mktp CA      _V,316.95,0.0,890.21,25,6,2022,Transportation
2022-06-23,SKIPTHEDISHES     _V,22.55,0.0,867.66,25,6,2022,Food
2022-06-23,JUICE ON THE LO   _F,21.46,0.0,846.2,25,6,2022,Entertainment
2022-06-24,REHAN'S YIG #16     ,300.93,0.0,545.27,25,6,2022,Bills
2022-06-24,WINE RACK 169     _F,22.55,0.0,522.72,25,6,2022,Groceries
2022-06-27,POPEYES #13854    _M,18.61,0.0,504.11,26,6,2022,Shopping
2022-06-27,GIANT TIGER # 2   _F,76.68,0.0,427.43,26,6,2022,Travel
2022-06-27,LCBO/RAO #0407    _F,26.0,0.0,401.43,26,6,2022,Shopping
2022-06-27,SKIPTHEDISHES     _V,22.55,0.0,378.88,26,6,2022,Transportation
2022-06-27,WINE RACK 169     _M,15.45,0.0,363.43,26,6,2022,Transportation
2022-06-29,DI GUSTO PIZZA      ,122.21,0.0,241.22,26,6,2022,Shopping
2022-06-30,REHAN'S YIG #16   _M,26.9,0.0,214.32,26,6,2022,Bills
2022-06-30,REHAN'S YIG #16   _F,1.99,0.0,212.33,26,6,2022,Groceries
2022-06-30,WINE RACK 169     _F,22.55,0.0,189.78,26,6,2022,Bills
2022-06-30,Sony Inter   11.29_V,11.29,0.0,178.49,26,6,2022,Groceries
2022-06-30,OTHER BANK FEES     ,2.0,0.0,176.49,26,6,2022,Shopping
2022-07-04,REHAN'S YIG #16   _M,9.54,0.0,166.95,27,7,2022,Food
2022-07-04,WINE RACK 169     _M,29.65,0.0,137.3,27,7,2022,Food
2022-07-04,CANNA CABANA      _F,31.0,0.0,106.3,27,7,2022,Travel
2022-07-04,REHAN'S YIG #16   _F,12.01,0.0,94.29,27,7,2022,Entertainment
2022-07-04,WINE RACK 169     _F,30.55,0.0,63.74,27,7,2022,Transportation
2022-07-04,TIM HORTONS #00   _F,2.72,0.0,61.02,27,7,2022,Travel
2022-07-04,SKIPTHEDISHES     _V,26.1,0.0,34.92,27,7,2022,Food
2022-07-05,WINE RACK 169     _M,26.1,0.0,8.82,27,7,2022,Shopping
2022-07-06,CANADA           PAY,0.0,1083.98,1092.8,27,7,2022,Other
2022-07-06,OKINAWA SUSHI     _F,104.46,0.0,988.34,27,7,2022,Entertainment
2022-07-07,SKIPTHEDISHES     _V,29.65,0.0,958.69,27,7,2022,Shopping
2022-07-07,SKIPTHEDISHES     _V,24.59,0.0,934.1,27,7,2022,Groceries
2022-07-07,        EQ BANK  FTD,200.0,0.0,734.1,27,7,2022,Transportation
2022-07-08,SKIPTHEDISHES     _V,29.65,0.0,704.45,27,7,2022,Groceries
2022-07-11,SKIPTHEDISHES     _V,24.65,0.0,679.8,28,7,2022,Groceries
2022-07-11,SHOPPERS DRUG M   _M,19.55,0.0,660.25,28,7,2022,Bills
2022-07-11,POPEYES #13854    _M,11.29,0.0,648.96,28,7,2022,Travel
2022-07-11,SKIPTHEDISHES     _V,26.1,0.0,622.86,28,7,2022,Shopping
2022-07-11,SEND E-TFR ***Nst   ,45.0,0.0,577.86,28,7,2022,Bills
2022-07-11,Highlife Cannab   _V,43.17,0.0,534.69,28,7,2022,Shopping
2022-07-11,SKIPTHEDISHES     _V,29.65,0.0,505.04,28,7,2022,Other
2022-07-11,TD ATM W/D    007609,40.0,0.0,465.04,28,7,2022,Shopping
2022-07-11,THE PITA PIT        ,12.76,0.0,452.28,28,7,2022,Transportation
2022-07-11,URIDE             _V,24.67,0.0,427.61,28,7,2022,Groceries
2022-07-12,URIDE    REV 07/11_V,0.0,24.67,452.28,28,7,2022,Bonus
2022-07-12,URIDE             _V,20.5,0.0,431.78,28,7,2022,Shopping
2022-07-12,SKIPTHEDISHES     _V,26.1,0.0,405.68,28,7,2022,Travel
2022-07-13,SKIPTHEDISHES     _V,22.55,0.0,383.13,28,7,2022,Bills
2022-07-14,SKIPTHEDISHES     _V,22.55,0.0,360.58,28,7,2022,Groceries
2022-07-14,7 STAR DUMPLING   _M,32.75,0.0,327.83,28,7,2022,Other
2022-07-18,NON-TD ATM W/D      ,23.0,0.0,304.83,29,7,2022,Shopping
2022-07-18,SH VENDING80036   _M,2.65,0.0,302.18,29,7,2022,Entertainment
2022-07-18,SH VENDING80036   _M,2.65,0.0,299.53,29,7,2022,Bills
2022-07-18,SEND E-TFR ***5eK   ,30.0,0.0,269.53,29,7,2022,Travel
2022-07-18,VESPA ST KITCHE   _M,36.13,0.0,233.4,29,7,2022,Other
2022-07-18,VESPA ST KITCHE   _M,6.76,0.0,226.64,29,7,2022,Shopping
2022-07-18,WINE RACK 169     _M,37.7,0.0,188.94,29,7,2022,Shopping
2022-07-18,SQ *ECLOUDZ       _F,25.98,0.0,162.96,29,7,2022,Travel
2022-07-19,Five Guys         _M,31.14,0.0,131.82,29,7,2022,Bills
2022-07-20,CANADA           PAY,0.0,941.39,1073.21,29,7,2022,Salary
2022-07-20,REHAN'S YIG #16   _M,29.37,0.0,1043.84,29,7,2022,Bills
2022-07-20,WINE RACK 169     _M,30.6,0.0,1013.24,29,7,2022,Groceries
2022-07-21,SEND E-TFR ***G6n   ,5.0,0.0,1008.24,29,7,2022,Transportation
2022-07-21,SUB WORLD         _M,30.15,0.0,978.09,29,7,2022,Entertainment
2022-07-21,WINE RACK 169     _M,37.0,0.0,941.09,29,7,2022,Shopping
2022-07-21,        EQ BANK  FTD,300.0,0.0,641.09,29,7,2022,Groceries
2022-07-22,MARY BROWNS #62   _M,12.75,0.0,628.34,29,7,2022,Food
2022-07-22,REHAN'S YIG #16   _M,7.0,0.0,621.34,29,7,2022,Shopping
2022-07-22,WINE RACK 169     _M,34.9,0.0,586.44,29,7,2022,Other
2022-07-25,WINE RACK 169     _M,28.9,0.0,557.54,30,7,2022,Bills
2022-07-25,CANNA CABANA      _M,34.34,0.0,523.2,30,7,2022,Travel
2022-07-25,Highlife Cannab   _V,27.11,0.0,496.09,30,7,2022,Groceries
2022-07-26,GINGERSNAP    1.00_V,1.0,0.0,495.09,30,7,2022,Entertainment
2022-07-26,SHOPPERS DRUG M   _M,22.59,0.0,472.5,30,7,2022,Entertainment
2022-07-27,Highlife Cannab   _V,27.11,0.0,445.39,30,7,2022,Bills
2022-07-28,SH VENDING80036   _M,2.4,0.0,442.99,30,7,2022,Groceries
2022-07-28,WINE RACK 169     _M,23.5,0.0,419.49,30,7,2022,Travel
2022-07-28,KFC #1533         _M,22.35,0.0,397.14,30,7,2022,Travel
2022-07-29,Highlife Cannab   _V,27.11,0.0,370.03,30,7,2022,Bills
2022-07-29,Subway            _M,32.39,0.0,337.64,30,7,2022,Groceries
2022-07-29,OTHER BANK FEES     ,2.0,0.0,335.64,30,7,2022,Bills
2022-08-02,SKIPTHEDISHES     _V,23.14,0.0,312.5,31,8,2022,Entertainment
2022-08-02,AMZN Mktp CA      _V,124.84,0.0,187.66,31,8,2022,Entertainment
2022-08-02,NEW BURGER PLAN   _V,17.52,0.0,170.14,31,8,2022,Shopping
2022-08-02,JUICE ON THE LO   _M,11.29,0.0,158.85,31,8,2022,Bills
2022-08-02,WATERSHED 144     _M,8.75,0.0,150.1,31,8,2022,Transportation
2022-08-02,D   A FINE MEAT   _M,22.26,0.0,127.84,31,8,2022,Shopping
2022-08-02,REHAN'S YIG #16   _M,27.81,0.0,100.03,31,8,2022,Food
2022-08-02,JUICE ON THE LO   _M,11.29,0.0,88.74,31,8,2022,Bills
2022-08-02,SKIPTHEDISHES     _V,22.55,0.0,66.19,31,8,2022,Transportation
2022-08-03,CANADA           PAY,0.0,1083.86,1150.05,31,8,2022,Other
2022-08-03,UBER* EATS PEND   _V,20.32,0.0,1129.73,31,8,2022,Other
2022-08-03,DI GUSTO PIZZA    _F,133.85,0.0,995.88,31,8,2022,Food
2022-08-04,Highlife Cannab   _V,27.11,0.0,968.77,31,8,2022,Transportation
2022-08-05,REHAN'S YIG #16   _M,11.97,0.0,956.8,31,8,2022,Entertainment
2022-08-05,WINE RACK 169     _M,30.6,0.0,926.2,31,8,2022,Entertainment
2022-08-05,JUICE ON THE LO   _M,11.29,0.0,914.91,31,8,2022,Bills
2022-08-08,SKIPTHEDISHES     _V,29.65,0.0,885.26,32,8,2022,Travel
2022-08-08,Highlife Cannab   _V,27.11,0.0,858.15,32,8,2022,Other
2022-08-08,SH VENDING80036   _M,2.65,0.0,855.5,32,8,2022,Groceries
2022-08-08,REHAN'S YIG #16   _M,126.73,0.0,728.77,32,8,2022,Entertainment
2022-08-08,WINE RACK 169     _M,24.45,0.0,704.32,32,8,2022,Groceries
2022-08-08,BOOSTER JUICE #   _M,9.54,0.0,694.78,32,8,2022,Other
2022-08-08,KFC #1533         _M,11.18,0.0,683.6,32,8,2022,Entertainment
2022-08-08,Highlife Cannab   _V,31.9,0.0,651.7,32,8,2022,Groceries
2022-08-08,SKIPTHEDISHES     _V,22.55,0.0,629.15,32,8,2022,Entertainment
2022-08-08,UBER CANADA       _V,15.21,0.0,613.94,32,8,2022,Entertainment
2022-08-08,JUICE ON THE LO   _F,21.46,0.0,592.48,32,8,2022,Transportation
2022-08-08,URIDE             _V,23.38,0.0,569.1,32,8,2022,Entertainment
2022-08-09,URIDE    REV 08/08_V,0.0,23.38,592.48,32,8,2022,Salary
2022-08-09,URIDE             _V,20.15,0.0,572.33,32,8,2022,Groceries
2022-08-09,SKIPTHEDISHES     _V,22.55,0.0,549.78,32,8,2022,Food
2022-08-10,SKIPTHEDISHES     _V,22.55,0.0,527.23,32,8,2022,Bills
2022-08-11,SKIPTHEDISHES     _V,25.05,0.0,502.18,32,8,2022,Transportation
2022-08-11,UBER* EATS PEND   _V,29.71,0.0,472.47,32,8,2022,Other
2022-08-12,SKIPTHEDISHES     _V,20.05,0.0,452.42,32,8,2022,Shopping
2022-08-12,UBER CANADA       _V,13.33,0.0,439.09,32,8,2022,Food
2022-08-15,JUICE ON THE LO   _M,14.68,0.0,424.41,33,8,2022,Shopping
2022-08-15,WINE RACK 169     _M,17.95,0.0,406.46,33,8,2022,Food
2022-08-15,THE LAUGHING BU   _M,39.64,0.0,366.82,33,8,2022,Food
2022-08-15,SKIPTHEDISHES     _V,25.05,0.0,341.77,33,8,2022,Transportation
2022-08-15,SKIPTHEDISHES     _V,35.86,0.0,305.91,33,8,2022,Travel
2022-08-15,SKIPTHEDISHES     _V,25.05,0.0,280.86,33,8,2022,Bills
2022-08-16,UBER CANADA       _V,19.87,0.0,260.99,33,8,2022,Travel
2022-08-16,JUICE ON THE LO   _M,21.46,0.0,239.53,33,8,2022,Travel
2022-08-16,WINE RACK 169     _M,21.5,0.0,218.03,33,8,2022,Groceries
2022-08-16,Highlife Cannab   _V,27.11,0.0,190.92,33,8,2022,Bills
2022-08-17,CANADA           PAY,0.0,225.48,416.4,33,8,2022,Bonus
2022-08-17,CANADA           PAY,0.0,819.54,1235.94,33,8,2022,Interest
2022-08-17,SKIPTHEDISHES     _V,25.05,0.0,1210.89,33,8,2022,Bills
2022-08-17,UBER CANADA       _V,16.92,0.0,1193.97,33,8,2022,Travel
2022-08-18,SEND E-TFR ***Rmf   ,5.0,0.0,1188.97,33,8,2022,Entertainment
2022-08-18,SEND E-TFR ***tVJ   ,5.0,0.0,1183.97,33,8,2022,Shopping
2022-08-18,SKIPTHEDISHES     _V,25.05,0.0,1158.92,33,8,2022,Other
2022-08-18,UBER* EATS PEND   _V,27.45,0.0,1131.47,33,8,2022,Travel
2022-08-18,        EQ BANK  FTD,300.0,0.0,831.47,33,8,2022,Bills
2022-08-19,NON-TD ATM W/D      ,23.0,0.0,808.47,33,8,2022,Transportation
2022-08-19,JUICE ON THE LO   _M,14.68,0.0,793.79,33,8,2022,Other
2022-08-19,WINE RACK 169     _M,39.45,0.0,754.34,33,8,2022,Travel
2022-08-19,Store             _M,12.42,0.0,741.92,33,8,2022,Entertainment
2022-08-19,URIDE             _V,17.62,0.0,724.3,33,8,2022,Groceries
2022-08-22,URIDE    REV 08/19_V,0.0,17.62,741.92,34,8,2022,Bonus
2022-08-22,URIDE             _V,13.74,0.0,728.18,34,8,2022,Other
2022-08-22,UBER* EATS PEND   _V,22.45,0.0,705.73,34,8,2022,Other
2022-08-22,SKIPTHEDISHES     _V,35.86,0.0,669.87,34,8,2022,Other
2022-08-22,SKIPTHEDISHES     _V,28.6,0.0,641.27,34,8,2022,Bills
2022-08-22,UBER CANADA       _V,28.45,0.0,612.82,34,8,2022,Transportation
2022-08-22,SKIPTHEDISHES     _V,43.69,0.0,569.13,34,8,2022,Food
2022-08-22,SH VENDING80036   _M,2.4,0.0,566.73,34,8,2022,Shopping
2022-08-22,SKIPTHEDISHES     _V,18.71,0.0,548.02,34,8,2022,Groceries
2022-08-23,OKINAWA SUSHI     _M,111.7,0.0,436.32,34,8,2022,Other
2022-08-23,JUICE ON THE LO   _M,21.46,0.0,414.86,34,8,2022,Entertainment
2022-08-24,FIVE GUYS BURGE   _V,20.42,0.0,394.44,34,8,2022,Entertainment
2022-08-24,THE BARBER SHOP   _M,39.29,0.0,355.15,34,8,2022,Other
2022-08-24,LCBO/RAO #652     _M,22.45,0.0,332.7,34,8,2022,Transportation
2022-08-24,A W #4598         _M,15.01,0.0,317.69,34,8,2022,Bills
2022-08-25,UBER* EATS PEND   _V,21.88,0.0,295.81,34,8,2022,Travel
2022-08-25,WINE RACK 169     _M,20.5,0.0,275.31,34,8,2022,Other
2022-08-25,CANNA CABANA      _M,23.61,0.0,251.7,34,8,2022,Transportation
2022-08-25,Store             _M,34.54,0.0,217.16,34,8,2022,Travel
2022-08-26,POPEYES #13854    _M,24.84,0.0,192.32,34,8,2022,Travel
2022-08-26,WATERSHED 144     _M,4.46,0.0,187.86,34,8,2022,Shopping
2022-08-29,NEW BURGER PLAN   _V,19.5,0.0,168.36,35,8,2022,Groceries
2022-08-29,JUICE ON THE LO   _M,14.68,0.0,153.68,35,8,2022,Groceries
2022-08-29,MISS JONES TIMM   _M,44.02,0.0,109.66,35,8,2022,Groceries
2022-08-29,Store             _M,26.97,0.0,82.69,35,8,2022,Other
2022-08-29,E-TRANSFER ***9HS   ,0.0,3000.0,3082.69,35,8,2022,Other
2022-08-29,LRNTN UNIV   H3X7H9 ,2500.0,0.0,582.69,35,8,2022,Transportation
2022-08-29,DI GUSTO PIZZA    _M,114.61,0.0,468.08,35,8,2022,Bills
2022-08-29,CANNA CABANA      _M,15.8,0.0,452.28,35,8,2022,Transportation
2022-08-30,E-TRANSFER ***pT2   ,0.0,3000.0,3452.28,35,8,2022,Bonus
2022-08-30,LRNTN UNIV   H6X4H3 ,3000.0,0.0,452.28,35,8,2022,Travel
2022-08-30,MTO E-COMMERCE    _V,91.25,0.0,361.03,35,8,2022,Transportation
2022-08-30,MTO E-COMMERCE    _V,91.25,0.0,269.78,35,8,2022,Food
2022-08-31,CANADA           PAY,0.0,1013.64,1283.42,35,8,2022,Salary
2022-08-31,OTHER BANK FEES     ,2.0,0.0,1281.42,35,8,2022,Entertainment
2022-09-01,SPIRITLEAF - SA   _M,40.0,0.0,1241.42,35,9,2022,Bills
2022-09-01,THE INDIAN STRE   _M,10.72,0.0,1230.7,35,9,2022,Groceries
2022-09-01,180 SMOKE         _M,11.29,0.0,1219.41,35,9,2022,Travel
2022-09-01,ICECREAM CAFE     _M,3.94,0.0,1215.47,35,9,2022,Food
2022-09-01,        EQ BANK  FTD,200.0,0.0,1015.47,35,9,2022,Shopping
2022-09-06,MTO E-CO REV 08/30_V,0.0,91.25,1106.72,36,9,2022,Other
2022-09-06,TIM HORTONS #30   _M,11.73,0.0,1094.99,36,9,2022,Bills
2022-09-06,REHAN'S YIG #16   _M,12.23,0.0,1082.76,36,9,2022,Transportation
2022-09-06,LCBO/RAO #0407    _M,15.95,0.0,1066.81,36,9,2022,Other
2022-09-07,SKIPTHEDISHES     _V,28.0,0.0,1038.81,36,9,2022,Bills
2022-09-08,JUICE ON THE LO   _M,33.88,0.0,1004.93,36,9,2022,Shopping
2022-09-08,WINE RACK 169     _M,23.35,0.0,981.58,36,9,2022,Transportation
2022-09-08,TIM HORTONS #04   _M,5.87,0.0,975.71,36,9,2022,Travel
2022-09-08,CHARTWELLS-1755   _M,21.66,0.0,954.05,36,9,2022,Other
2022-09-09,CHARTWELLS-1755   _M,11.29,0.0,942.76,36,9,2022,Travel
2022-09-09,SKIPTHEDISHES     _V,27.6,0.0,915.16,36,9,2022,Transportation
2022-09-12,UBER* EATS PEND   _V,22.8,0.0,892.36,37,9,2022,Transportation
2022-09-12,SH VENDING80036   _M,1.9,0.0,890.46,37,9,2022,Bills
2022-09-12,SHOPPERS DRUG M   _M,41.72,0.0,848.74,37,9,2022,Shopping
2022-09-12,REHAN'S YIG #16   _M,45.4,0.0,803.34,37,9,2022,Travel
2022-09-12,WINE RACK 169     _M,31.9,0.0,771.44,37,9,2022,Food
2022-09-12,D   A FINE MEAT   _M,3.26,0.0,768.18,37,9,2022,Shopping
2022-09-12,UBER CANADA       _V,38.64,0.0,729.54,37,9,2022,Other
2022-09-12,PIZZERIA ROMA 1   _M,17.68,0.0,711.86,37,9,2022,Entertainment
2022-09-12,PIZZERIA ROMA 1   _M,1.25,0.0,710.61,37,9,2022,Food
2022-09-12,SHOPPERS DRUG M   _M,112.5,0.0,598.11,37,9,2022,Shopping
2022-09-12,CANNA CABANA      _M,34.34,0.0,563.77,37,9,2022,Entertainment
2022-09-12,FOOD BASICS  63   _M,20.84,0.0,542.93,37,9,2022,Entertainment
2022-09-12,BOOSTER JUICE #   _M,10.33,0.0,532.6,37,9,2022,Other
2022-09-13,CHARTWELLS-1755   _M,0.51,0.0,532.09,37,9,2022,Travel
2022-09-13,TIM HORTONS #04   _M,5.87,0.0,526.22,37,9,2022,Shopping
2022-09-13,SKIPTHEDISHES     _V,24.05,0.0,502.17,37,9,2022,Transportation
2022-09-13,SKIPTHEDISHES     _V,30.24,0.0,471.93,37,9,2022,Food
2022-09-14,SKIPTHEDISHES     _V,7.76,0.0,464.17,37,9,2022,Entertainment
2022-09-14,CANADA           PAY,0.0,900.54,1364.71,37,9,2022,Salary
2022-09-14,REHAN'S YIG #16   _M,141.65,0.0,1223.06,37,9,2022,Groceries
2022-09-14,WINE RACK 169     _M,20.5,0.0,1202.56,37,9,2022,Bills
2022-09-14,D   A FINE MEAT   _M,21.71,0.0,1180.85,37,9,2022,Other
2022-09-15,SKIPTHEDISHES     _V,24.05,0.0,1156.8,37,9,2022,Food
2022-09-15,        EQ BANK  FTD,300.0,0.0,856.8,37,9,2022,Travel
2022-09-16,SKIPTHEDISHES     _V,22.6,0.0,834.2,37,9,2022,Travel
2022-09-16,PIZZERIA ROMA 1   _M,50.91,0.0,783.29,37,9,2022,Transportation
2022-09-19,CORA SUDBURY      _M,41.41,0.0,741.88,38,9,2022,Shopping
2022-09-19,REHAN'S YIG #16   _M,5.99,0.0,735.89,38,9,2022,Transportation
2022-09-19,WINE RACK 169     _M,20.5,0.0,715.39,38,9,2022,Bills
2022-09-19,REHAN'S YIG #16   _M,7.99,0.0,707.4,38,9,2022,Groceries
2022-09-19,WINE RACK 169     _M,20.5,0.0,686.9,38,9,2022,Groceries
2022-09-19,KFC #1533         _M,2.36,0.0,684.54,38,9,2022,Shopping
2022-09-19,SEND E-TFR ***PjP   ,18.0,0.0,666.54,38,9,2022,Other
2022-09-19,WINE RACK 169     _M,14.95,0.0,651.59,38,9,2022,Transportation
2022-09-20,LCBO/RAO #0407    _M,25.45,0.0,626.14,38,9,2022,Groceries
2022-09-20,UBER CANADA       _V,24.78,0.0,601.36,38,9,2022,Bills
2022-09-20,SKIPTHEDISHES     _V,17.05,0.0,584.31,38,9,2022,Food
2022-09-21,SKIPTHEDISHES     _V,21.16,0.0,563.15,38,9,2022,Food
2022-09-22,WINE RACK 169     _M,18.9,0.0,544.25,38,9,2022,Groceries
2022-09-22,TIM HORTONS #04   _M,5.63,0.0,538.62,38,9,2022,Bills
2022-09-23,MCDONALD'S #250   _M,3.82,0.0,534.8,38,9,2022,Shopping
2022-09-23,SUKHDEV RESTAUR   _M,20.82,0.0,513.98,38,9,2022,Groceries
2022-09-23,ESSO MCKERROW #   _M,9.38,0.0,504.6,38,9,2022,Bills
2022-09-23,SH VENDING80036   _M,2.65,0.0,501.95,38,9,2022,Transportation
2022-09-26,SKIPTHEDISHES     _V,24.05,0.0,477.9,39,9,2022,Transportation
2022-09-26,AARON TAXI        _M,24.5,0.0,453.4,39,9,2022,Bills
2022-09-26,AARON TAXI        _M,44.0,0.0,409.4,39,9,2022,Travel
2022-09-26,JUICE ON THE LO   _M,33.88,0.0,375.52,39,9,2022,Food
2022-09-26,MCDONALD'S #311   _M,16.6,0.0,358.92,39,9,2022,Shopping
2022-09-26,WINE RACK 169     _M,14.95,0.0,343.97,39,9,2022,Other
2022-09-26,DAMASCUS RESTAU   _M,11.06,0.0,332.91,39,9,2022,Bills
2022-09-26,DAMASCUS RESTAU   _M,1.7,0.0,331.21,39,9,2022,Transportation
2022-09-26,REHAN'S YIG #16   _M,18.17,0.0,313.04,39,9,2022,Other
2022-09-26,WINE RACK 169     _M,14.95,0.0,298.09,39,9,2022,Bills
2022-09-26,UBER* EATS PEND   _V,47.05,0.0,251.04,39,9,2022,Travel
2022-09-26,UBER* EATS PEND   _V,0.0,47.05,298.09,39,9,2022,Interest
2022-09-27,MARY BROWNS #62   _M,13.55,0.0,284.54,39,9,2022,Entertainment
2022-09-27,LCBO/RAO #0407    _M,14.0,0.0,270.54,39,9,2022,Bills
2022-09-28,CANADA           PAY,0.0,517.34,787.88,39,9,2022,Interest
2022-09-29,PIZZERIA ROMA 1   _M,22.71,0.0,765.17,39,9,2022,Other
2022-09-29,WINE RACK 166     _M,18.9,0.0,746.27,39,9,2022,Travel
2022-09-29,INTEREST CREDIT     ,0.0,0.01,746.28,39,9,2022,Bonus
2022-10-03,SKIPTHEDISHES     _V,24.05,0.0,722.23,40,10,2022,Food
2022-10-03,WINE RACK 169     _M,18.9,0.0,703.33,40,10,2022,Food
2022-10-03,OSMOW'S           _M,20.6,0.0,682.73,40,10,2022,Food
2022-10-03,SQ *NICKEL CITY   _M,33.9,0.0,648.83,40,10,2022,Transportation
2022-10-03,POPEYES #13854    _M,11.29,0.0,637.54,40,10,2022,Other
2022-10-03,POPEYES #13854    _M,7.9,0.0,629.64,40,10,2022,Food
2022-10-03,E-TRANSFER ***Np9   ,0.0,200.0,829.64,40,10,2022,Bonus
2022-10-03,REHAN'S YIG #16   _M,249.7,0.0,579.94,40,10,2022,Shopping
2022-10-03,WINE RACK 169     _M,18.9,0.0,561.04,40,10,2022,Shopping
2022-10-03,SEND E-TFR ***uGB   ,48.0,0.0,513.04,40,10,2022,Travel
2022-10-03,LCBO/RAO #0407    _M,14.5,0.0,498.54,40,10,2022,Bills
2022-10-03,JUICE ON THE LO   _M,33.88,0.0,464.66,40,10,2022,Other
2022-10-03,        EQ BANK  FTD,200.0,0.0,264.66,40,10,2022,Transportation
2022-10-04,SKIPTHEDISHES     _V,24.05,0.0,240.61,40,10,2022,Groceries
2022-10-06,UBER* EATS PEND   _V,16.92,0.0,223.69,40,10,2022,Bills
2022-10-06,UBER* EATS PEND   _V,1.13,0.0,222.56,40,10,2022,Groceries
2022-10-06,WINE RACK 169     _M,24.9,0.0,197.66,40,10,2022,Transportation
2022-10-06,DD                _V,44.04,0.0,153.62,40,10,2022,Bills
2022-10-06,E-TRANSFER ***74v   ,0.0,30.0,183.62,40,10,2022,Interest
2022-10-07,WINE RACK 169     _M,14.95,0.0,168.67,40,10,2022,Entertainment
2022-10-07,CHARTWELLS-1755   _M,10.72,0.0,157.95,40,10,2022,Bills
2022-10-07,CANNA CABANA      _M,27.9,0.0,130.05,40,10,2022,Shopping
2022-10-07,KEY MARINE RESO   _M,2.47,0.0,127.58,40,10,2022,Other
2022-10-11,MTO RUS-SO BRAM   _M,36.0,0.0,91.58,41,10,2022,Travel
2022-10-11,SHELL C12185      _M,5.0,0.0,86.58,41,10,2022,Groceries
2022-10-11,SEND E-TFR ***p7z   ,50.0,0.0,36.58,41,10,2022,Entertainment
2022-10-12,CANADA           PAY,0.0,593.67,630.25,41,10,2022,Salary
2022-10-12,REHAN'S YIG #16   _M,71.02,0.0,559.23,41,10,2022,Other
2022-10-12,WINE RACK 169     _M,23.95,0.0,535.28,41,10,2022,Transportation
2022-10-13,LRNTN UNIV   J3X8R3 ,75.0,0.0,460.28,41,10,2022,Bills
2022-10-14,D   A FINE MEAT   _M,7.63,0.0,452.65,41,10,2022,Other
2022-10-14,KFC #1533         _M,11.85,0.0,440.8,41,10,2022,Groceries
2022-10-14,        EQ BANK  FTD,100.0,0.0,340.8,41,10,2022,Food
2022-10-17,THE LAUGHING BU   _M,55.94,0.0,284.86,42,10,2022,Food
2022-10-17,Store             _M,10.71,0.0,274.15,42,10,2022,Groceries
2022-10-17,CHARTWELLS-1755   _M,6.2,0.0,267.95,42,10,2022,Entertainment
2022-10-18,WALMART STORE #   _M,30.48,0.0,237.47,42,10,2022,Transportation
2022-10-18,JUICE ON THE LO   _M,33.88,0.0,203.59,42,10,2022,Other
2022-10-19,UBER CANADA       _V,27.21,0.0,176.38,42,10,2022,Travel
2022-10-19,LCBO/RAO #0407    _M,15.25,0.0,161.13,42,10,2022,Food
2022-10-20,CANNA CABANA      _M,28.87,0.0,132.26,42,10,2022,Transportation
2022-10-20,CHARTWELLS-1755   _M,7.9,0.0,124.36,42,10,2022,Travel
2022-10-20,E-TRANSFER ***3Z5   ,0.0,150.0,274.36,42,10,2022,Interest
2022-10-20,REHAN'S YIG #16   _M,6.99,0.0,267.37,42,10,2022,Transportation
2022-10-20,WINE RACK 169     _M,22.05,0.0,245.32,42,10,2022,Food
2022-10-20,SHOPPERS DRUG M   _M,96.01,0.0,149.31,42,10,2022,Groceries
2022-10-21,LCBO/RAO #0407    _M,14.95,0.0,134.36,42,10,2022,Food
2022-10-21,DOLLARAMA # 302   _M,8.57,0.0,125.79,42,10,2022,Groceries
2022-10-21,A W #4562         _M,18.06,0.0,107.73,42,10,2022,Groceries
2022-10-21,SKIPTHEDISHES     _V,27.04,0.0,80.69,42,10,2022,Shopping
2022-10-24,LCBO/RAO #0407    _M,16.45,0.0,64.24,43,10,2022,Entertainment
2022-10-24,Store             _M,12.42,0.0,51.82,43,10,2022,Travel
2022-10-24,TIM HORTONS #00   _M,8.78,0.0,43.04,43,10,2022,Shopping
2022-10-24,WINE RACK 169     _M,19.9,0.0,23.14,43,10,2022,Transportation
2022-10-24,CHARTWELLS-1755   _M,7.9,0.0,15.24,43,10,2022,Bills
2022-10-24,LCBO/RAO #0407    _M,11.95,0.0,3.29,43,10,2022,Food
2022-10-25,E-TRANSFER ***Ub6   ,0.0,25.0,28.29,43,10,2022,Interest
2022-10-25,SKIPTHEDISHES     _V,24.05,0.0,4.24,43,10,2022,Entertainment
2022-10-25,E-TRANSFER ***xAM   ,0.0,20.0,24.24,43,10,2022,Interest
2022-10-25,SKIPTHEDISHES     _V,24.05,0.0,0.19,43,10,2022,Transportation
2022-10-26,CANADA           PAY,0.0,593.67,593.86,43,10,2022,Interest
2022-10-26,SKIPTHEDISHES     _V,0.56,0.0,593.3,43,10,2022,Transportation
2022-10-26,Highlife Cannab   _V,27.11,0.0,566.19,43,10,2022,Bills
2022-10-26,CHARTWELLS-1755   _M,12.87,0.0,553.32,43,10,2022,Travel
2022-10-27,CHARTWELLS-1755   _M,9.35,0.0,543.97,43,10,2022,Bills
2022-10-27,WINE RACK 169     _M,16.95,0.0,527.02,43,10,2022,Groceries
2022-10-28,JD SOUTHERN SMO   _M,20.34,0.0,506.68,43,10,2022,Transportation
2022-10-28,JD SOUTHERN SMO   _M,2.63,0.0,504.05,43,10,2022,Entertainment
2022-10-28,WINE RACK 169     _M,16.95,0.0,487.1,43,10,2022,Shopping
2022-10-31,SKIPTHEDISHES     _V,24.9,0.0,462.2,44,10,2022,Entertainment
2022-10-31,D   A FINE MEAT   _M,17.25,0.0,444.95,44,10,2022,Shopping
2022-10-31,REHAN'S YIG #16   _M,17.95,0.0,427.0,44,10,2022,Shopping
2022-10-31,WINE RACK 169     _M,16.95,0.0,410.05,44,10,2022,Travel
2022-10-31,KFC #1533         _M,11.85,0.0,398.2,44,10,2022,Food
2022-10-31,Highlife Cannab   _V,27.11,0.0,371.09,44,10,2022,Entertainment
2022-10-31,CHARTWELLS-1755   _M,12.87,0.0,358.22,44,10,2022,Other
2022-10-31,CHARTWELLS-1755   _M,7.9,0.0,350.32,44,10,2022,Shopping
2022-10-31,SH VENDING80036   _M,2.9,0.0,347.42,44,10,2022,Entertainment
2022-10-31,E-TRANSFER ***8gJ   ,0.0,80.0,427.42,44,10,2022,Interest
2022-10-31,SEND E-TFR ***x83   ,80.0,0.0,347.42,44,10,2022,Shopping
2022-11-01,SH VENDING80036   _M,3.4,0.0,344.02,44,11,2022,Food
2022-11-01,LCBO/RAO #0407    _M,21.75,0.0,322.27,44,11,2022,Other
2022-11-01,MCDONALD'S #311   _M,6.77,0.0,315.5,44,11,2022,Groceries
2022-11-02,LCBO/RAO #652     _M,18.6,0.0,296.9,44,11,2022,Groceries
2022-11-02,UBER* EATS PEND   _V,23.67,0.0,273.23,44,11,2022,Food
2022-11-03,REHAN'S YIG #16   _M,14.68,0.0,258.55,44,11,2022,Entertainment
2022-11-03,WINE RACK 169     _M,14.95,0.0,243.6,44,11,2022,Shopping
2022-11-03,MCDONALD'S #311   _M,8.69,0.0,234.91,44,11,2022,Food
2022-11-07,SQ *ECLOUDZ       _M,33.87,0.0,201.04,45,11,2022,Other
2022-11-07,OKINAWA SUSHI     _M,55.96,0.0,145.08,45,11,2022,Entertainment
2022-11-07,WINE RACK 169     _M,16.95,0.0,128.13,45,11,2022,Groceries
2022-11-07,LCBO/RAO #0407    _M,15.75,0.0,112.38,45,11,2022,Transportation
2022-11-07,SUBWAY            _M,12.42,0.0,99.96,45,11,2022,Entertainment
2022-11-07,UBER CANADA       _V,21.21,0.0,78.75,45,11,2022,Travel
2022-11-07,CHARTWELLS-1755   _M,12.87,0.0,65.88,45,11,2022,Transportation
2022-11-08,TIM HORTONS #04   _M,2.09,0.0,63.79,45,11,2022,Transportation
2022-11-08,REHAN'S YIG #16   _M,22.59,0.0,41.2,45,11,2022,Shopping
2022-11-08,WINE RACK 169     _M,16.95,0.0,24.25,45,11,2022,Entertainment
2022-11-09,CANADA           PAY,0.0,358.55,382.8,45,11,2022,Interest
2022-11-09,UBER CANADA       _V,27.21,0.0,355.59,45,11,2022,Entertainment
2022-11-09,SKIPTHEDISHES     _V,25.58,0.0,330.01,45,11,2022,Other
2022-11-09,SKIPTHEDISHES     _V,35.86,0.0,294.15,45,11,2022,Travel
2022-11-10,SKIPTHEDISHES     _V,24.05,0.0,270.1,45,11,2022,Other
2022-11-14,SKIPTHEDISHES     _V,61.79,0.0,208.31,46,11,2022,Transportation
2022-11-14,Teklenburg's Se   _M,103.9,0.0,104.41,46,11,2022,Groceries
2022-11-14,LCBO/RAO #0287    _M,29.95,0.0,74.46,46,11,2022,Food
2022-11-14,LCBO/RAO #0050    _M,26.4,0.0,48.06,46,11,2022,Other
2022-11-14,WINE RACK 169     _M,18.5,0.0,29.56,46,11,2022,Groceries
2022-11-14,UBER* EATS PEND   _V,16.0,0.0,13.56,46,11,2022,Food
2022-11-14,E-TRANSFER ***5P7   ,0.0,100.0,113.56,46,11,2022,Other
2022-11-14,Highlife Cannab   _V,27.11,0.0,86.45,46,11,2022,Entertainment
2022-11-14,E-TRANSFER ***bUZ   ,0.0,200.0,286.45,46,11,2022,Other
2022-11-15,DI GUSTO PIZZA    _M,100.05,0.0,186.4,46,11,2022,Shopping
2022-11-16,SKIPTHEDISHES     _V,22.6,0.0,163.8,46,11,2022,Other
2022-11-16,SKIPTHEDISHES     _V,17.05,0.0,146.75,46,11,2022,Travel
2022-11-16,SEND E-TFR ***W9x   ,60.0,0.0,86.75,46,11,2022,Travel
2022-11-17,UBER* EATS PEND   _V,16.68,0.0,70.07,46,11,2022,Entertainment
2022-11-17,Store             _M,9.82,0.0,60.25,46,11,2022,Other
2022-11-18,GINGERSNAP    1.00_V,1.0,0.0,59.25,46,11,2022,Entertainment
2022-11-18,SEND E-TFR ***K4P   ,30.0,0.0,29.25,46,11,2022,Transportation
2022-11-21,E-TRANSFER ***vUR   ,0.0,60.0,89.25,47,11,2022,Interest
2022-11-21,SEND E-TFR ***thx   ,30.0,0.0,59.25,47,11,2022,Entertainment
2022-11-21,FOOD BASICS  63   _M,22.01,0.0,37.24,47,11,2022,Other
2022-11-21,LCBO/RAO #0407    _M,18.05,0.0,19.19,47,11,2022,Shopping
2022-11-21,E-TRANSFER ***NJB   ,0.0,50.0,69.19,47,11,2022,Interest
2022-11-21,WINE RACK 169     _M,18.5,0.0,50.69,47,11,2022,Other
2022-11-21,CANNA CABANA      _M,8.35,0.0,42.34,47,11,2022,Bills
2022-11-21,CHARTWELLS-1755   _M,5.97,0.0,36.37,47,11,2022,Groceries
2022-11-21,SH VENDING80036   _M,2.9,0.0,33.47,47,11,2022,Travel
2022-11-21,SKIPTHEDISHES     _V,24.05,0.0,9.42,47,11,2022,Travel
2022-11-22,SH VENDING80036   _M,2.9,0.0,6.52,47,11,2022,Bills
2022-11-22,SH VENDING80036   _M,3.4,0.0,3.12,47,11,2022,Other
2022-11-22,E-TRANSFER ***YCm   ,0.0,60.0,63.12,47,11,2022,Interest
2022-11-22,HEALTH SCIENCES   _M,3.0,0.0,60.12,47,11,2022,Bills
2022-11-22,LCBO/RAO #0407    _M,15.4,0.0,44.72,47,11,2022,Shopping
2022-11-22,WALMART STORE #   _M,5.54,0.0,39.18,47,11,2022,Bills
2022-11-22,MCDONALD'S #403   _M,12.98,0.0,26.2,47,11,2022,Travel
2022-11-22,WALMART STORE #   _M,10.78,0.0,15.42,47,11,2022,Entertainment
2022-11-22,SHOPPERS DRUG M   _M,2.42,0.0,13.0,47,11,2022,Travel
2022-11-23,CANADA           PAY,0.0,350.66,363.66,47,11,2022,Salary
2022-11-23,UBER CANADA       _V,38.39,0.0,325.27,47,11,2022,Groceries
2022-11-23,REHAN'S YIG #16   _M,20.34,0.0,304.93,47,11,2022,Travel
2022-11-23,WINE RACK 169     _M,14.95,0.0,289.98,47,11,2022,Groceries
2022-11-23,JUICE ON THE LO   _M,33.88,0.0,256.1,47,11,2022,Groceries
2022-11-24,CANADA           GSL,0.0,2123.93,2380.03,47,11,2022,Bonus
2022-11-24,SEND E-TFR ***sc6   ,150.0,0.0,2230.03,47,11,2022,Groceries
2022-11-24,SKIPTHEDISHES     _V,30.6,0.0,2199.43,47,11,2022,Food
2022-11-25,DD                _V,16.34,0.0,2183.09,47,11,2022,Other
2022-11-25,SKIPTHEDISHES     _V,20.6,0.0,2162.49,47,11,2022,Other
2022-11-25,UBER CANADA       _V,39.94,0.0,2122.55,47,11,2022,Entertainment
2022-11-25,        EQ BANK  FTD,1000.0,0.0,1122.55,47,11,2022,Food
2022-11-28,D   A FINE MEAT   _M,134.1,0.0,988.45,48,11,2022,Other
2022-11-28,WINE RACK 169     _M,18.5,0.0,969.95,48,11,2022,Shopping
2022-11-28,SHOPPERS DRUG M   _M,96.01,0.0,873.94,48,11,2022,Transportation
2022-11-28,SKIPTHEDISHES     _V,24.05,0.0,849.89,48,11,2022,Shopping
2022-11-28,EM&MAY            _V,113.83,0.0,736.06,48,11,2022,Food
2022-11-28,CHARTWELLS-1755   _M,10.7,0.0,725.36,48,11,2022,Shopping
2022-11-28,        EQ BANK  FTD,600.0,0.0,125.36,48,11,2022,Groceries
2022-11-29,SKIPTHEDISHES     _V,22.6,0.0,102.76,48,11,2022,Groceries
2022-11-30,CHARTWELLS-1755   _M,21.32,0.0,81.44,48,11,2022,Transportation
2022-11-30,SKIPTHEDISHES     _V,27.0,0.0,54.44,48,11,2022,Shopping
2022-12-01,CHARTWELLS-1755   _M,12.51,0.0,41.93,48,12,2022,Travel
2022-12-01,E-TRANSFER ***U9j   ,0.0,100.0,141.93,48,12,2022,Interest
2022-12-01,WINE RACK 169     _M,33.9,0.0,108.03,48,12,2022,Entertainment
2022-12-01,CANNA CABANA      _M,26.56,0.0,81.47,48,12,2022,Entertainment
2022-12-05,DOORDASH*SAHAR    _V,29.31,0.0,52.16,49,12,2022,Bills
2022-12-05,SKIPTHEDISHES     _V,19.05,0.0,33.11,49,12,2022,Other
2022-12-05,SEND E-TFR ***6XH   ,25.0,0.0,8.11,49,12,2022,Groceries
2022-12-05,E-TRANSFER ***3EK   ,0.0,50.0,58.11,49,12,2022,Salary
2022-12-05,CHARTWELLS-1755   _M,12.87,0.0,45.24,49,12,2022,Food
2022-12-07,CANADA           PAY,0.0,593.67,638.91,49,12,2022,Salary
2022-12-07,DD                _V,27.92,0.0,610.99,49,12,2022,Food
2022-12-07,REHAN'S YIG #16   _M,115.97,0.0,495.02,49,12,2022,Groceries
2022-12-07,PETRO-CANADA      _M,18.14,0.0,476.88,49,12,2022,Travel
2022-12-07,LCBO/RAO #0407    _M,50.3,0.0,426.58,49,12,2022,Shopping
2022-12-07,JUICE ON THE LO   _M,40.66,0.0,385.92,49,12,2022,Food
2022-12-09,UBER CANADA       _V,30.24,0.0,355.68,49,12,2022,Bills
2022-12-09,GINGERSNAP    1.00_V,0.0,1.0,356.68,49,12,2022,Salary
2022-12-12,CANNA CABANA      _M,8.19,0.0,348.49,50,12,2022,Entertainment
2022-12-12,DI GUSTO PIZZA    _M,48.59,0.0,299.9,50,12,2022,Other
2022-12-12,SKIPTHEDISHES     _V,34.0,0.0,265.9,50,12,2022,Other
2022-12-12,TIM HORTONS #04   _M,7.67,0.0,258.23,50,12,2022,Entertainment
2022-12-13,KFC #1533         _M,27.66,0.0,230.57,50,12,2022,Travel
2022-12-14,SKIPTHEDISHES     _V,18.45,0.0,212.12,50,12,2022,Bills
2022-12-14,SKIPTHEDISHES     _V,24.05,0.0,188.07,50,12,2022,Entertainment
2022-12-15,SKIPTHEDISHES     _V,26.05,0.0,162.02,50,12,2022,Shopping
2022-12-16,FOCUS MEDICAL     _V,25.0,0.0,137.02,50,12,2022,Entertainment
2022-12-16,E-TRANSFER ***p9f   ,0.0,80.0,217.02,50,12,2022,Other
2022-12-19,RISTORANTE VERD     ,151.08,0.0,65.94,51,12,2022,Bills
2022-12-19,SHELL C08820      _M,10.14,0.0,55.8,51,12,2022,Transportation
2022-12-19,E-TRANSFER ***y2J   ,0.0,55.0,110.8,51,12,2022,Interest
2022-12-19,D   A FINE MEAT   _M,29.31,0.0,81.49,51,12,2022,Food
2022-12-19,LCBO/RAO #0407    _M,50.3,0.0,31.19,51,12,2022,Groceries
2022-12-19,REGENCY BAKERY    _M,1.2,0.0,29.99,51,12,2022,Transportation
2022-12-19,Highlife Cannab   _V,27.11,0.0,2.88,51,12,2022,Entertainment
2022-12-20,E-TRANSFER ***nrH   ,0.0,40.0,42.88,51,12,2022,Interest
2022-12-20,SKIPTHEDISHES     _V,27.6,0.0,15.28,51,12,2022,Entertainment
2022-12-21,CANADA           PAY,0.0,116.35,131.63,51,12,2022,Salary
2022-12-21,CANADA           PAY,0.0,484.06,615.69,51,12,2022,Salary
2022-12-21,SKIPTHEDISHES     _V,25.7,0.0,589.99,51,12,2022,Food
2022-12-21,SKIPTHEDISHES     _V,18.05,0.0,571.94,51,12,2022,Food
2022-12-22,SKIPTHEDISHES     _V,25.15,0.0,546.79,51,12,2022,Shopping
2022-12-22,HARVEYS #2472     _M,14.68,0.0,532.11,51,12,2022,Groceries
2022-12-23,SEND E-TFR ***NWH   ,55.0,0.0,477.11,51,12,2022,Travel
2022-12-28,VALUE BUDS FLET   _M,27.09,0.0,450.02,52,12,2022,Transportation
2022-12-28,LCBO/RAO #470     _M,16.1,0.0,433.92,52,12,2022,Other
2022-12-28,SP CUCHARA JEWE   _V,201.14,0.0,232.78,52,12,2022,Food
2022-12-28,LCBO/RAO #        _M,16.1,0.0,216.68,52,12,2022,Food
2022-12-28,LCBO/RAO #0470    _M,16.1,0.0,200.58,52,12,2022,Entertainment
2022-12-29,LCBO/RAO #470     _M,16.1,0.0,184.48,52,12,2022,Other
2022-12-30,LCBO/RAO #470     _M,16.1,0.0,168.38,52,12,2022,Groceries
2023-01-03,LCBO/RAO #470     _M,16.1,0.0,152.28,1,1,2023,Groceries
2023-01-03,HARVEYS #2472     _M,14.23,0.0,138.05,1,1,2023,Food
2023-01-03,SKIPTHEDISHES     _V,19.05,0.0,119.0,1,1,2023,Travel
2023-01-03,DI GUSTO PIZZA    _M,111.22,0.0,7.78,1,1,2023,Food
2023-01-03,E-TRANSFER ***wCW   ,0.0,50.0,57.78,1,1,2023,Bonus
2023-01-03,SWEET SEVEN CAN   _M,31.63,0.0,26.15,1,1,2023,Other
2023-01-03,E-TRANSFER ***mCb   ,0.0,73.0,99.15,1,1,2023,Bonus
2023-01-03,PIZZERIA ROMA 1   _M,13.5,0.0,85.65,1,1,2023,Entertainment
2023-01-03,E-TRANSFER ***F8j   ,0.0,100.0,185.65,1,1,2023,Interest
2023-01-03,SHOPPERS DRUG M   _M,96.01,0.0,89.64,1,1,2023,Travel
2023-01-03,E-TRANSFER ***PU7   ,0.0,20.0,109.64,1,1,2023,Interest
2023-01-04,KIN HAO SUSHI A   _M,99.92,0.0,9.72,1,1,2023,Entertainment
2023-01-04,CANADA           PAY,0.0,272.98,282.7,1,1,2023,Bonus
2023-01-06,SH VENDING80036   _M,2.9,0.0,279.8,1,1,2023,Other
2023-01-09,DD                _V,30.5,0.0,249.3,2,1,2023,Travel
2023-01-09,JUICE ON THE LO   _M,20.33,0.0,228.97,2,1,2023,Food
2023-01-09,E-TRANSFER ***Hpr   ,0.0,3000.0,3228.97,2,1,2023,Interest
2023-01-09,LRNTN UNIV   K8U5Z4 ,2900.0,0.0,328.97,2,1,2023,Travel
2023-01-09,CHARTWELLS-1755   _M,10.7,0.0,318.27,2,1,2023,Food
2023-01-09,AMZN Mktp CA      _V,9.2,0.0,309.07,2,1,2023,Other
2023-01-10,E-TRANSFER ***94D   ,0.0,2200.0,2509.07,2,1,2023,Bonus
2023-01-10,LRNTN UNIV   L5Y4L8 ,2200.0,0.0,309.07,2,1,2023,Bills
2023-01-10,REGENCY BAKERY    _M,30.86,0.0,278.21,2,1,2023,Transportation
2023-01-10,D   A FINE MEAT   _M,74.88,0.0,203.33,2,1,2023,Travel
2023-01-10,WINE RACK 169     _M,18.9,0.0,184.43,2,1,2023,Entertainment
2023-01-11,Highlife Cannab   _V,27.46,0.0,156.97,2,1,2023,Shopping
2023-01-11,LCBO/RAO #0407    _M,11.95,0.0,145.02,2,1,2023,Entertainment
2023-01-12,GOODFOOD M* GOO   _V,4.0,0.0,141.02,2,1,2023,Transportation
2023-01-12,WINE RACK 169     _M,18.5,0.0,122.52,2,1,2023,Shopping
2023-01-12,OSMOW'S           _M,19.75,0.0,102.77,2,1,2023,Groceries
2023-01-13,E-TRANSFER ***gdF   ,0.0,100.0,202.77,2,1,2023,Interest
2023-01-13,LRNTN UNIV   Q7A3K3 ,105.38,0.0,97.39,2,1,2023,Entertainment
2023-01-13,LCBO/RAO #0287    _M,27.05,0.0,70.34,2,1,2023,Shopping
2023-01-16,SKIPTHEDISHES     _V,27.05,0.0,43.29,3,1,2023,Transportation
2023-01-16,E-TRANSFER ***kBN   ,0.0,80.0,123.29,3,1,2023,Other
2023-01-16,WINE RACK 169     _M,22.05,0.0,101.24,3,1,2023,Groceries
2023-01-16,MCDONALD'S #311   _M,14.55,0.0,86.69,3,1,2023,Groceries
2023-01-16,JUICE ON THE LO   _M,79.08,0.0,7.61,3,1,2023,Bills
2023-01-16,GINGERSNAP    1.00_V,1.0,0.0,6.61,3,1,2023,Shopping
2023-01-17,GINGERSNAP    1.00_V,1.0,0.0,5.61,3,1,2023,Travel
2023-01-17,E-TRANSFER ***tcn   ,0.0,30.0,35.61,3,1,2023,Other
2023-01-17,CHARTWELLS-1755   _M,6.2,0.0,29.41,3,1,2023,Groceries
2023-01-17,SKIPTHEDISHES     _V,27.6,0.0,1.81,3,1,2023,Groceries
2023-01-18,CANADA           PAY,0.0,235.99,237.8,3,1,2023,Other
2023-01-18,SKIPTHEDISHES     _V,27.6,0.0,210.2,3,1,2023,Transportation
2023-01-19,WINE RACK 169     _M,20.5,0.0,189.7,3,1,2023,Food
2023-01-19,KFC #1533         _M,22.01,0.0,167.69,3,1,2023,Shopping
2023-01-20,TWIGGS COFFEE R   _V,17.23,0.0,150.46,3,1,2023,Travel
2023-01-20,Five Guys         _M,33.86,0.0,116.6,3,1,2023,Groceries
2023-01-20,E-TRANSFER ***qDN   ,0.0,15.0,131.6,3,1,2023,Bonus
2023-01-20,SKIPTHEDISHES     _V,48.1,0.0,83.5,3,1,2023,Food
2023-01-20,DD                _V,29.14,0.0,54.36,3,1,2023,Entertainment
2023-01-23,Highlife Cannab   _V,27.11,0.0,27.25,4,1,2023,Transportation
2023-01-23,SKIPTHEDISHES     _V,24.6,0.0,2.65,4,1,2023,Food
2023-01-23,E-TRANSFER ***jXE   ,0.0,100.0,102.65,4,1,2023,Interest
2023-01-23,KIN HAO SUSHI A   _M,84.63,0.0,18.02,4,1,2023,Shopping
2023-01-23,E-TRANSFER ***5ur   ,0.0,50.0,68.02,4,1,2023,Bonus
2023-01-23,SKIPTHEDISHES     _V,30.6,0.0,37.42,4,1,2023,Groceries
2023-01-24,CHARTWELLS-1755   _M,6.2,0.0,31.22,4,1,2023,Travel
2023-01-24,SH VENDING80036   _M,2.9,0.0,28.32,4,1,2023,Transportation
2023-01-25,SH VENDING80036   _M,1.9,0.0,26.42,4,1,2023,Other
2023-01-25,SH VENDING80036   _M,1.9,0.0,24.52,4,1,2023,Shopping
2023-01-25,LCBO/RAO #0407    _M,23.15,0.0,1.37,4,1,2023,Travel
2023-01-26,E-TRANSFER ***cun   ,0.0,50.0,51.37,4,1,2023,Other
2023-01-26,SKIPTHEDISHES     _V,19.39,0.0,31.98,4,1,2023,Entertainment
2023-01-27,LCBO/RAO #0407    _M,22.85,0.0,9.13,4,1,2023,Food
2023-01-27,E-TRANSFER ***qrs   ,0.0,30.0,39.13,4,1,2023,Bonus
2023-01-30,UBER CANADA       _V,25.74,0.0,13.39,5,1,2023,Other
2023-01-30,E-TRANSFER ***WME   ,0.0,40.0,53.39,5,1,2023,Bonus
2023-01-30,THE BARBER SHOP   _M,41.29,0.0,12.1,5,1,2023,Groceries
2023-01-30,E-TRANSFER ***hwP   ,0.0,25.0,37.1,5,1,2023,Interest
2023-01-30,LCBO/RAO #652     _M,23.25,0.0,13.85,5,1,2023,Other
2023-01-30,ESSO SUDBURY #2   _M,9.6,0.0,4.25,5,1,2023,Food
2023-01-30,E-TRANSFER ***feM   ,0.0,75.0,79.25,5,1,2023,Interest
2023-01-30,THAI EXPRESS      _M,32.44,0.0,46.81,5,1,2023,Groceries
2023-01-30,LCBO/RAO #0287    _M,2.8,0.0,44.01,5,1,2023,Groceries
2023-01-30,PIZZERIA ROMA 1   _M,15.93,0.0,28.08,5,1,2023,Travel
2023-01-30,SHELL C07151      _M,8.69,0.0,19.39,5,1,2023,Transportation
2023-01-30,SHELL C07151      _M,1.46,0.0,17.93,5,1,2023,Transportation
2023-01-31,CHARTWELLS-1755   _M,9.35,0.0,8.58,5,1,2023,Food
2023-01-31,E-TRANSFER ***2dA   ,0.0,50.0,58.58,5,1,2023,Bonus
2023-01-31,LCBO/RAO #0407    _M,20.1,0.0,38.48,5,1,2023,Shopping
2023-01-31,A W #4562         _M,24.39,0.0,14.09,5,1,2023,Transportation
2023-01-31,E-TRANSFER ***FSx   ,0.0,20.0,34.09,5,1,2023,Salary
2023-01-31,SHELL C08820      _M,16.79,0.0,17.3,5,1,2023,Bills
