Date,Withdrawal,Deposit,Balance,Week,Month,Year,Category
2022-02-07,0.0,20.65,78.36,6,2,2022,Bonus
2022-02-07,16.93,0.0,61.43,6,2,2022,Dining Out
2022-02-14,5.07,0.0,56.36,7,2,2022,Transportation
2022-02-16,0.0,458.56,514.92,7,2,2022,Return on Investement
2022-02-16,4.24,0.0,510.68,7,2,2022,Dining Out
2022-02-16,12.0,0.0,498.68,7,2,2022,Groceries
2022-02-16,32.94,0.0,465.74,7,2,2022,Transportation
2022-02-17,25.24,0.0,440.5,7,2,2022,Housing
2022-02-17,22.99,0.0,417.51,7,2,2022,Dining Out
2022-02-17,17.84,0.0,399.67,7,2,2022,Housing
2022-02-18,32.94,0.0,366.73,7,2,2022,Loan Payment
2022-02-18,10.69,0.0,356.04,7,2,2022,Bills
2022-02-22,21.29,0.0,334.75,8,2,2022,Shopping
2022-02-28,32.94,0.0,301.81,9,2,2022,Loan Payment
2022-02-28,23.34,0.0,278.47,9,2,2022,Entertainment
2022-02-28,100.0,0.0,178.47,9,2,2022,Loan Payment
2022-02-28,24.21,0.0,154.26,9,2,2022,Entertainment
2022-03-01,35.5,0.0,118.76,9,3,2022,Housing
2022-03-02,0.0,571.29,690.05,9,3,2022,Personal Sale
2022-03-02,29.45,0.0,660.6,9,3,2022,Entertainment
2022-03-02,8.6,0.0,652.0,9,3,2022,Loan Payment
2022-03-03,0.0,300.0,952.0,9,3,2022,Return on Investement
2022-03-03,300.0,0.0,652.0,9,3,2022,Groceries
2022-03-03,18.07,0.0,633.93,9,3,2022,Shopping
2022-03-03,104.05,0.0,529.88,9,3,2022,Groceries
2022-03-03,14.89,0.0,514.99,9,3,2022,Housing
2022-03-03,22.55,0.0,492.44,9,3,2022,Housing
2022-03-04,29.45,0.0,462.99,9,3,2022,Bills
2022-03-04,53.21,0.0,409.78,9,3,2022,Housing
2022-03-07,29.45,0.0,380.33,10,3,2022,Dining Out
2022-03-07,19.05,0.0,361.28,10,3,2022,Dining Out
2022-03-07,29.45,0.0,331.83,10,3,2022,Entertainment
2022-03-07,22.57,0.0,309.26,10,3,2022,Groceries
2022-03-07,22.55,0.0,286.71,10,3,2022,Dining Out
2022-03-07,28.2,0.0,258.51,10,3,2022,Transportation
2022-03-08,9.5,0.0,249.01,10,3,2022,Dining Out
2022-03-08,22.55,0.0,226.46,10,3,2022,Loan Payment
2022-03-09,123.0,0.0,103.46,10,3,2022,Housing
2022-03-09,22.55,0.0,80.91,10,3,2022,Groceries
2022-03-10,29.45,0.0,51.46,10,3,2022,Bills
2022-03-10,33.55,0.0,17.91,10,3,2022,Bills
2022-03-10,0.0,70.0,87.91,10,3,2022,Interest
2022-03-11,29.45,0.0,58.46,10,3,2022,Dining Out
2022-03-14,29.45,0.0,29.01,11,3,2022,Loan Payment
2022-03-14,18.05,0.0,10.96,11,3,2022,Entertainment
2022-03-16,0.0,571.29,582.25,11,3,2022,Interest
2022-03-16,29.45,0.0,552.8,11,3,2022,Groceries
2022-03-16,17.05,0.0,535.75,11,3,2022,Housing
2022-03-17,12.4,0.0,523.35,11,3,2022,Housing
2022-03-17,19.58,0.0,503.77,11,3,2022,Dining Out
2022-03-17,17.05,0.0,486.72,11,3,2022,Loan Payment
2022-03-18,32.5,0.0,454.22,11,3,2022,Loan Payment
2022-03-21,18.39,0.0,435.83,12,3,2022,Groceries
2022-03-21,24.45,0.0,411.38,12,3,2022,Entertainment
2022-03-21,375.98,0.0,35.4,12,3,2022,Loan Payment
2022-03-21,0.0,50.0,85.4,12,3,2022,Personal Sale
2022-03-21,31.79,0.0,53.61,12,3,2022,Dining Out
2022-03-21,29.45,0.0,24.16,12,3,2022,Bills
2022-03-21,22.36,0.0,1.8,12,3,2022,Entertainment
2022-03-22,0.0,150.0,151.8,12,3,2022,Return on Investement
2022-03-22,29.45,0.0,122.35,12,3,2022,Groceries
2022-03-23,22.55,0.0,99.8,12,3,2022,Dining Out
2022-03-24,22.55,0.0,77.25,12,3,2022,Dining Out
2022-03-25,0.0,500.0,577.25,12,3,2022,Salary
2022-03-25,29.45,0.0,547.8,12,3,2022,Dining Out
2022-03-28,2.0,0.0,545.8,13,3,2022,Entertainment
2022-03-28,34.42,0.0,511.38,13,3,2022,Loan Payment
2022-03-28,21.46,0.0,489.92,13,3,2022,Transportation
2022-03-28,46.67,0.0,443.25,13,3,2022,Dining Out
2022-03-28,11.46,0.0,431.79,13,3,2022,Dining Out
2022-03-28,42.99,0.0,388.8,13,3,2022,Housing
2022-03-28,27.35,0.0,361.45,13,3,2022,Transportation
2022-03-28,15.77,0.0,345.68,13,3,2022,Groceries
2022-03-28,0.0,50.0,395.68,13,3,2022,Personal Sale
2022-03-28,30.2,0.0,365.48,13,3,2022,Shopping
2022-03-28,25.99,0.0,339.49,13,3,2022,Transportation
2022-03-28,35.9,0.0,303.59,13,3,2022,Transportation
2022-03-29,13.2,0.0,290.39,13,3,2022,Groceries
2022-03-29,49.94,0.0,240.45,13,3,2022,Loan Payment
2022-03-29,36.72,0.0,203.73,13,3,2022,Bills
2022-03-29,0.0,27.35,231.08,13,3,2022,Interest
2022-03-29,25.98,0.0,205.1,13,3,2022,Housing
2022-03-29,78.11,0.0,126.99,13,3,2022,Housing
2022-03-30,22.55,0.0,104.44,13,3,2022,Shopping
2022-03-30,0.0,571.29,675.73,13,3,2022,Bonus
2022-03-30,40.68,0.0,635.05,13,3,2022,Shopping
2022-03-30,17.0,0.0,618.05,13,3,2022,Housing
2022-03-30,40.25,0.0,577.8,13,3,2022,Transportation
2022-03-30,42.68,0.0,535.12,13,3,2022,Housing
2022-03-30,120.7,0.0,414.42,13,3,2022,Dining Out
2022-03-31,16.94,0.0,397.48,13,3,2022,Entertainment
2022-03-31,27.07,0.0,370.41,13,3,2022,Shopping
2022-03-31,48.75,0.0,321.66,13,3,2022,Housing
2022-03-31,4.0,0.0,317.66,13,3,2022,Entertainment
2022-04-01,32.53,0.0,285.13,13,4,2022,Shopping
2022-04-01,22.55,0.0,262.58,13,4,2022,Entertainment
2022-04-04,64.0,0.0,198.58,14,4,2022,Shopping
2022-04-04,48.2,0.0,150.38,14,4,2022,Transportation
2022-04-05,0.0,74.75,225.13,14,4,2022,Salary
2022-04-05,26.1,0.0,199.03,14,4,2022,Dining Out
2022-04-06,33.88,0.0,165.15,14,4,2022,Transportation
2022-04-06,22.55,0.0,142.6,14,4,2022,Housing
2022-04-06,10.58,0.0,132.02,14,4,2022,Transportation
2022-04-06,8.5,0.0,123.52,14,4,2022,Entertainment
2022-04-07,26.1,0.0,97.42,14,4,2022,Bills
2022-04-07,42.6,0.0,54.82,14,4,2022,Shopping
2022-04-11,22.55,0.0,32.27,15,4,2022,Loan Payment
2022-04-11,23.75,0.0,8.52,15,4,2022,Entertainment
2022-04-13,0.0,571.29,579.81,15,4,2022,Bonus
2022-04-13,22.55,0.0,557.26,15,4,2022,Transportation
2022-04-13,32.53,0.0,524.73,15,4,2022,Housing
2022-04-14,500.0,0.0,24.73,15,4,2022,Transportation
2022-04-14,22.55,0.0,2.18,15,4,2022,Transportation
2022-04-27,0.0,571.29,573.47,17,4,2022,Interest
2022-04-27,19.22,0.0,554.25,17,4,2022,Housing
2022-04-27,0.39,0.0,553.86,17,4,2022,Bills
2022-04-27,7.67,0.0,546.19,17,4,2022,Transportation
2022-04-27,34.34,0.0,511.85,17,4,2022,Entertainment
2022-04-27,20.33,0.0,491.52,17,4,2022,Groceries
2022-04-27,18.85,0.0,472.67,17,4,2022,Dining Out
2022-04-27,0.15,0.0,472.52,17,4,2022,Transportation
2022-04-27,24.15,0.0,448.37,17,4,2022,Housing
2022-04-27,18.62,0.0,429.75,17,4,2022,Entertainment
2022-04-29,24.17,0.0,405.58,17,4,2022,Housing
2022-04-29,20.29,0.0,385.29,17,4,2022,Loan Payment
2022-04-29,3.75,0.0,381.54,17,4,2022,Loan Payment
2022-04-29,4.0,0.0,377.54,17,4,2022,Groceries
2022-05-02,22.6,0.0,354.94,18,5,2022,Shopping
2022-05-02,5.75,0.0,349.19,18,5,2022,Groceries
2022-05-02,39.54,0.0,309.65,18,5,2022,Housing
2022-05-03,10.64,0.0,299.01,18,5,2022,Bills
2022-05-03,1.7,0.0,297.31,18,5,2022,Transportation
2022-05-05,33.01,0.0,264.3,18,5,2022,Bills
2022-05-05,20.33,0.0,243.97,18,5,2022,Housing
2022-05-05,10.95,0.0,233.02,18,5,2022,Entertainment
2022-05-05,3.4,0.0,229.62,18,5,2022,Dining Out
2022-05-06,3.4,0.0,226.22,18,5,2022,Transportation
2022-05-06,17.75,0.0,208.47,18,5,2022,Loan Payment
2022-05-06,7.32,0.0,201.15,18,5,2022,Loan Payment
2022-05-06,38.13,0.0,163.02,18,5,2022,Groceries
2022-05-09,11.3,0.0,151.72,19,5,2022,Shopping
2022-05-09,39.54,0.0,112.18,19,5,2022,Loan Payment
2022-05-09,14.99,0.0,97.19,19,5,2022,Loan Payment
2022-05-09,18.59,0.0,78.6,19,5,2022,Transportation
2022-05-09,1.13,0.0,77.47,19,5,2022,Shopping
2022-05-09,12.09,0.0,65.38,19,5,2022,Groceries
2022-05-09,22.6,0.0,42.78,19,5,2022,Loan Payment
2022-05-09,21.5,0.0,21.28,19,5,2022,Transportation
2022-05-10,18.45,0.0,2.83,19,5,2022,Groceries
2022-05-11,0.0,364.07,366.9,19,5,2022,Salary
2022-05-12,37.28,0.0,329.62,19,5,2022,Groceries
2022-05-12,4.86,0.0,324.76,19,5,2022,Bills
2022-05-12,19.13,0.0,305.63,19,5,2022,Entertainment
2022-05-13,7.9,0.0,297.73,19,5,2022,Loan Payment
2022-05-13,23.35,0.0,274.38,19,5,2022,Entertainment
2022-05-16,19.2,0.0,255.18,20,5,2022,Loan Payment
2022-05-16,26.1,0.0,229.08,20,5,2022,Shopping
2022-05-16,1.9,0.0,227.18,20,5,2022,Entertainment
2022-05-16,3.65,0.0,223.53,20,5,2022,Entertainment
2022-05-16,40.25,0.0,183.28,20,5,2022,Bills
2022-05-16,8.99,0.0,174.29,20,5,2022,Loan Payment
2022-05-16,39.09,0.0,135.2,20,5,2022,Entertainment
2022-05-16,22.6,0.0,112.6,20,5,2022,Groceries
2022-05-16,7.9,0.0,104.7,20,5,2022,Entertainment
2022-05-16,40.67,0.0,64.03,20,5,2022,Entertainment
2022-05-18,13.95,0.0,50.08,20,5,2022,Loan Payment
2022-05-18,4.69,0.0,45.39,20,5,2022,Bills
2022-05-19,22.6,0.0,22.79,20,5,2022,Loan Payment
2022-05-19,3.1,0.0,19.69,20,5,2022,Entertainment
2022-05-24,17.75,0.0,1.94,21,5,2022,Groceries
2022-05-25,0.0,61.59,63.53,21,5,2022,Salary
2022-05-25,0.0,978.51,1042.04,21,5,2022,Interest
2022-05-25,400.0,0.0,642.04,21,5,2022,Shopping
2022-05-25,22.55,0.0,619.49,21,5,2022,Bills
2022-05-25,85.08,0.0,534.41,21,5,2022,Bills
2022-05-25,80.6,0.0,453.81,21,5,2022,Loan Payment
2022-05-25,6.43,0.0,447.38,21,5,2022,Loan Payment
2022-05-27,1.13,0.0,446.25,21,5,2022,Loan Payment
2022-05-27,24.37,0.0,421.88,21,5,2022,Groceries
2022-05-27,62.85,0.0,359.03,21,5,2022,Dining Out
2022-05-27,53.57,0.0,305.46,21,5,2022,Bills
2022-05-30,19.75,0.0,285.71,22,5,2022,Groceries
2022-05-30,15.45,0.0,270.26,22,5,2022,Dining Out
2022-05-30,20.33,0.0,249.93,22,5,2022,Shopping
2022-05-30,30.13,0.0,219.8,22,5,2022,Groceries
2022-05-31,5.57,0.0,214.23,22,5,2022,Bills
2022-05-31,34.06,0.0,180.17,22,5,2022,Housing
2022-05-31,53.58,0.0,126.59,22,5,2022,Housing
2022-05-31,16.93,0.0,109.66,22,5,2022,Groceries
2022-06-01,22.55,0.0,87.11,22,6,2022,Transportation
2022-06-02,22.55,0.0,64.56,22,6,2022,Bills
2022-06-03,43.0,0.0,21.56,22,6,2022,Bills
2022-06-03,2.65,0.0,18.91,22,6,2022,Shopping
2022-06-03,18.35,0.0,0.56,22,6,2022,Entertainment
2022-06-07,0.0,40.0,40.56,23,6,2022,Return on Investement
2022-06-07,40.0,0.0,0.56,23,6,2022,Bills
2022-06-08,0.0,1083.97,1084.53,23,6,2022,Interest
2022-06-08,22.55,0.0,1061.98,23,6,2022,Shopping
2022-06-08,25.86,0.0,1036.12,23,6,2022,Entertainment
2022-06-08,22.59,0.0,1013.53,23,6,2022,Dining Out
2022-06-08,11.97,0.0,1001.56,23,6,2022,Shopping
2022-06-08,24.79,0.0,976.77,23,6,2022,Housing
2022-06-08,3.1,0.0,973.67,23,6,2022,Transportation
2022-06-09,0.0,25.86,999.53,23,6,2022,Bonus
2022-06-09,22.96,0.0,976.57,23,6,2022,Shopping
2022-06-09,0.0,24.79,1001.36,23,6,2022,Salary
2022-06-09,19.15,0.0,982.21,23,6,2022,Bills
2022-06-09,0.0,3000.0,3982.21,23,6,2022,Interest
2022-06-09,3000.0,0.0,982.21,23,6,2022,Groceries
2022-06-09,17.55,0.0,964.66,23,6,2022,Groceries
2022-06-09,16.55,0.0,948.11,23,6,2022,Loan Payment
2022-06-10,0.0,3000.0,3948.11,23,6,2022,Return on Investement
2022-06-10,2500.0,0.0,1448.11,23,6,2022,Dining Out
2022-06-10,22.55,0.0,1425.56,23,6,2022,Housing
2022-06-10,245.0,0.0,1180.56,23,6,2022,Transportation
2022-06-10,41.29,0.0,1139.27,23,6,2022,Dining Out
2022-06-10,33.27,0.0,1106.0,23,6,2022,Housing
2022-06-13,110.01,0.0,995.99,24,6,2022,Dining Out
2022-06-13,120.08,0.0,875.91,24,6,2022,Loan Payment
2022-06-13,15.45,0.0,860.46,24,6,2022,Transportation
2022-06-13,18.07,0.0,842.39,24,6,2022,Groceries
2022-06-13,42.53,0.0,799.86,24,6,2022,Bills
2022-06-13,30.24,0.0,769.62,24,6,2022,Shopping
2022-06-13,2.65,0.0,766.97,24,6,2022,Groceries
2022-06-14,19.75,0.0,747.22,24,6,2022,Groceries
2022-06-14,28.24,0.0,718.98,24,6,2022,Entertainment
2022-06-15,22.55,0.0,696.43,24,6,2022,Entertainment
2022-06-15,22.55,0.0,673.88,24,6,2022,Bills
2022-06-15,0.0,22.55,696.43,24,6,2022,Return on Investement
2022-06-16,22.55,0.0,673.88,24,6,2022,Housing
2022-06-17,21.6,0.0,652.28,24,6,2022,Dining Out
2022-06-17,4.19,0.0,648.09,24,6,2022,Groceries
2022-06-20,22.6,0.0,625.49,25,6,2022,Dining Out
2022-06-20,16.0,0.0,609.49,25,6,2022,Dining Out
2022-06-20,38.41,0.0,571.08,25,6,2022,Groceries
2022-06-20,362.55,0.0,208.53,25,6,2022,Housing
2022-06-21,50.0,0.0,158.53,25,6,2022,Loan Payment
2022-06-21,21.44,0.0,137.09,25,6,2022,Entertainment
2022-06-22,0.0,1083.96,1221.05,25,6,2022,Salary
2022-06-22,13.89,0.0,1207.16,25,6,2022,Transportation
2022-06-23,316.95,0.0,890.21,25,6,2022,Loan Payment
2022-06-23,22.55,0.0,867.66,25,6,2022,Loan Payment
2022-06-23,21.46,0.0,846.2,25,6,2022,Dining Out
2022-06-24,300.93,0.0,545.27,25,6,2022,Dining Out
2022-06-24,22.55,0.0,522.72,25,6,2022,Shopping
2022-06-27,18.61,0.0,504.11,26,6,2022,Dining Out
2022-06-27,76.68,0.0,427.43,26,6,2022,Transportation
2022-06-27,26.0,0.0,401.43,26,6,2022,Housing
2022-06-27,22.55,0.0,378.88,26,6,2022,Dining Out
2022-06-27,15.45,0.0,363.43,26,6,2022,Groceries
2022-06-29,122.21,0.0,241.22,26,6,2022,Housing
2022-06-30,26.9,0.0,214.32,26,6,2022,Loan Payment
2022-06-30,1.99,0.0,212.33,26,6,2022,Shopping
2022-06-30,22.55,0.0,189.78,26,6,2022,Transportation
2022-06-30,11.29,0.0,178.49,26,6,2022,Dining Out
2022-06-30,2.0,0.0,176.49,26,6,2022,Bills
2022-07-04,9.54,0.0,166.95,27,7,2022,Bills
2022-07-04,29.65,0.0,137.3,27,7,2022,Shopping
2022-07-04,31.0,0.0,106.3,27,7,2022,Bills
2022-07-04,12.01,0.0,94.29,27,7,2022,Loan Payment
2022-07-04,30.55,0.0,63.74,27,7,2022,Bills
2022-07-04,2.72,0.0,61.02,27,7,2022,Housing
2022-07-04,26.1,0.0,34.92,27,7,2022,Loan Payment
2022-07-05,26.1,0.0,8.82,27,7,2022,Transportation
2022-07-06,0.0,1083.98,1092.8,27,7,2022,Bonus
2022-07-06,104.46,0.0,988.34,27,7,2022,Dining Out
2022-07-07,29.65,0.0,958.69,27,7,2022,Bills
2022-07-07,24.59,0.0,934.1,27,7,2022,Entertainment
2022-07-07,200.0,0.0,734.1,27,7,2022,Shopping
2022-07-08,29.65,0.0,704.45,27,7,2022,Loan Payment
2022-07-11,24.65,0.0,679.8,28,7,2022,Groceries
2022-07-11,19.55,0.0,660.25,28,7,2022,Dining Out
2022-07-11,11.29,0.0,648.96,28,7,2022,Transportation
2022-07-11,26.1,0.0,622.86,28,7,2022,Housing
2022-07-11,45.0,0.0,577.86,28,7,2022,Dining Out
2022-07-11,43.17,0.0,534.69,28,7,2022,Bills
2022-07-11,29.65,0.0,505.04,28,7,2022,Transportation
2022-07-11,40.0,0.0,465.04,28,7,2022,Groceries
2022-07-11,12.76,0.0,452.28,28,7,2022,Bills
2022-07-11,24.67,0.0,427.61,28,7,2022,Transportation
2022-07-12,0.0,24.67,452.28,28,7,2022,Interest
2022-07-12,20.5,0.0,431.78,28,7,2022,Housing
2022-07-12,26.1,0.0,405.68,28,7,2022,Transportation
2022-07-13,22.55,0.0,383.13,28,7,2022,Transportation
2022-07-14,22.55,0.0,360.58,28,7,2022,Loan Payment
2022-07-14,32.75,0.0,327.83,28,7,2022,Housing
2022-07-18,23.0,0.0,304.83,29,7,2022,Bills
2022-07-18,2.65,0.0,302.18,29,7,2022,Groceries
2022-07-18,2.65,0.0,299.53,29,7,2022,Bills
2022-07-18,30.0,0.0,269.53,29,7,2022,Loan Payment
2022-07-18,36.13,0.0,233.4,29,7,2022,Housing
2022-07-18,6.76,0.0,226.64,29,7,2022,Entertainment
2022-07-18,37.7,0.0,188.94,29,7,2022,Entertainment
2022-07-18,25.98,0.0,162.96,29,7,2022,Transportation
2022-07-19,31.14,0.0,131.82,29,7,2022,Shopping
2022-07-20,0.0,941.39,1073.21,29,7,2022,Salary
2022-07-20,29.37,0.0,1043.84,29,7,2022,Shopping
2022-07-20,30.6,0.0,1013.24,29,7,2022,Bills
2022-07-21,5.0,0.0,1008.24,29,7,2022,Dining Out
2022-07-21,30.15,0.0,978.09,29,7,2022,Transportation
2022-07-21,37.0,0.0,941.09,29,7,2022,Dining Out
2022-07-21,300.0,0.0,641.09,29,7,2022,Dining Out
2022-07-22,12.75,0.0,628.34,29,7,2022,Bills
2022-07-22,7.0,0.0,621.34,29,7,2022,Dining Out
2022-07-22,34.9,0.0,586.44,29,7,2022,Groceries
2022-07-25,28.9,0.0,557.54,30,7,2022,Groceries
2022-07-25,34.34,0.0,523.2,30,7,2022,Housing
2022-07-25,27.11,0.0,496.09,30,7,2022,Shopping
2022-07-26,1.0,0.0,495.09,30,7,2022,Entertainment
2022-07-26,22.59,0.0,472.5,30,7,2022,Transportation
2022-07-27,27.11,0.0,445.39,30,7,2022,Entertainment
2022-07-28,2.4,0.0,442.99,30,7,2022,Entertainment
2022-07-28,23.5,0.0,419.49,30,7,2022,Dining Out
2022-07-28,22.35,0.0,397.14,30,7,2022,Transportation
2022-07-29,27.11,0.0,370.03,30,7,2022,Transportation
2022-07-29,32.39,0.0,337.64,30,7,2022,Bills
2022-07-29,2.0,0.0,335.64,30,7,2022,Dining Out
2022-08-02,23.14,0.0,312.5,31,8,2022,Entertainment
2022-08-02,124.84,0.0,187.66,31,8,2022,Housing
2022-08-02,17.52,0.0,170.14,31,8,2022,Transportation
2022-08-02,11.29,0.0,158.85,31,8,2022,Transportation
2022-08-02,8.75,0.0,150.1,31,8,2022,Housing
2022-08-02,22.26,0.0,127.84,31,8,2022,Entertainment
2022-08-02,27.81,0.0,100.03,31,8,2022,Dining Out
2022-08-02,11.29,0.0,88.74,31,8,2022,Transportation
2022-08-02,22.55,0.0,66.19,31,8,2022,Transportation
2022-08-03,0.0,1083.86,1150.05,31,8,2022,Return on Investement
2022-08-03,20.32,0.0,1129.73,31,8,2022,Groceries
2022-08-03,133.85,0.0,995.88,31,8,2022,Dining Out
2022-08-04,27.11,0.0,968.77,31,8,2022,Shopping
2022-08-05,11.97,0.0,956.8,31,8,2022,Shopping
2022-08-05,30.6,0.0,926.2,31,8,2022,Entertainment
2022-08-05,11.29,0.0,914.91,31,8,2022,Bills
2022-08-08,29.65,0.0,885.26,32,8,2022,Entertainment
2022-08-08,27.11,0.0,858.15,32,8,2022,Bills
2022-08-08,2.65,0.0,855.5,32,8,2022,Housing
2022-08-08,126.73,0.0,728.77,32,8,2022,Bills
2022-08-08,24.45,0.0,704.32,32,8,2022,Groceries
2022-08-08,9.54,0.0,694.78,32,8,2022,Transportation
2022-08-08,11.18,0.0,683.6,32,8,2022,Entertainment
2022-08-08,31.9,0.0,651.7,32,8,2022,Entertainment
2022-08-08,22.55,0.0,629.15,32,8,2022,Shopping
2022-08-08,15.21,0.0,613.94,32,8,2022,Dining Out
2022-08-08,21.46,0.0,592.48,32,8,2022,Groceries
2022-08-08,23.38,0.0,569.1,32,8,2022,Dining Out
2022-08-09,0.0,23.38,592.48,32,8,2022,Salary
2022-08-09,20.15,0.0,572.33,32,8,2022,Bills
2022-08-09,22.55,0.0,549.78,32,8,2022,Entertainment
2022-08-10,22.55,0.0,527.23,32,8,2022,Loan Payment
2022-08-11,25.05,0.0,502.18,32,8,2022,Housing
2022-08-11,29.71,0.0,472.47,32,8,2022,Transportation
2022-08-12,20.05,0.0,452.42,32,8,2022,Groceries
2022-08-12,13.33,0.0,439.09,32,8,2022,Shopping
2022-08-15,14.68,0.0,424.41,33,8,2022,Housing
2022-08-15,17.95,0.0,406.46,33,8,2022,Housing
2022-08-15,39.64,0.0,366.82,33,8,2022,Loan Payment
2022-08-15,25.05,0.0,341.77,33,8,2022,Housing
2022-08-15,35.86,0.0,305.91,33,8,2022,Dining Out
2022-08-15,25.05,0.0,280.86,33,8,2022,Transportation
2022-08-16,19.87,0.0,260.99,33,8,2022,Transportation
2022-08-16,21.46,0.0,239.53,33,8,2022,Housing
2022-08-16,21.5,0.0,218.03,33,8,2022,Dining Out
2022-08-16,27.11,0.0,190.92,33,8,2022,Dining Out
2022-08-17,0.0,225.48,416.4,33,8,2022,Interest
2022-08-17,0.0,819.54,1235.94,33,8,2022,Personal Sale
2022-08-17,25.05,0.0,1210.89,33,8,2022,Entertainment
2022-08-17,16.92,0.0,1193.97,33,8,2022,Transportation
2022-08-18,5.0,0.0,1188.97,33,8,2022,Loan Payment
2022-08-18,5.0,0.0,1183.97,33,8,2022,Loan Payment
2022-08-18,25.05,0.0,1158.92,33,8,2022,Transportation
2022-08-18,27.45,0.0,1131.47,33,8,2022,Groceries
2022-08-18,300.0,0.0,831.47,33,8,2022,Dining Out
2022-08-19,23.0,0.0,808.47,33,8,2022,Shopping
2022-08-19,14.68,0.0,793.79,33,8,2022,Dining Out
2022-08-19,39.45,0.0,754.34,33,8,2022,Housing
2022-08-19,12.42,0.0,741.92,33,8,2022,Bills
2022-08-19,17.62,0.0,724.3,33,8,2022,Transportation
2022-08-22,0.0,17.62,741.92,34,8,2022,Bonus
2022-08-22,13.74,0.0,728.18,34,8,2022,Transportation
2022-08-22,22.45,0.0,705.73,34,8,2022,Housing
2022-08-22,35.86,0.0,669.87,34,8,2022,Loan Payment
2022-08-22,28.6,0.0,641.27,34,8,2022,Loan Payment
2022-08-22,28.45,0.0,612.82,34,8,2022,Entertainment
2022-08-22,43.69,0.0,569.13,34,8,2022,Shopping
2022-08-22,2.4,0.0,566.73,34,8,2022,Groceries
2022-08-22,18.71,0.0,548.02,34,8,2022,Shopping
2022-08-23,111.7,0.0,436.32,34,8,2022,Housing
2022-08-23,21.46,0.0,414.86,34,8,2022,Housing
2022-08-24,20.42,0.0,394.44,34,8,2022,Bills
2022-08-24,39.29,0.0,355.15,34,8,2022,Groceries
2022-08-24,22.45,0.0,332.7,34,8,2022,Loan Payment
2022-08-24,15.01,0.0,317.69,34,8,2022,Housing
2022-08-25,21.88,0.0,295.81,34,8,2022,Groceries
2022-08-25,20.5,0.0,275.31,34,8,2022,Entertainment
2022-08-25,23.61,0.0,251.7,34,8,2022,Housing
2022-08-25,34.54,0.0,217.16,34,8,2022,Bills
2022-08-26,24.84,0.0,192.32,34,8,2022,Dining Out
2022-08-26,4.46,0.0,187.86,34,8,2022,Entertainment
2022-08-29,19.5,0.0,168.36,35,8,2022,Groceries
2022-08-29,14.68,0.0,153.68,35,8,2022,Entertainment
2022-08-29,44.02,0.0,109.66,35,8,2022,Housing
2022-08-29,26.97,0.0,82.69,35,8,2022,Loan Payment
2022-08-29,0.0,3000.0,3082.69,35,8,2022,Interest
2022-08-29,2500.0,0.0,582.69,35,8,2022,Bills
2022-08-29,114.61,0.0,468.08,35,8,2022,Transportation
2022-08-29,15.8,0.0,452.28,35,8,2022,Transportation
2022-08-30,0.0,3000.0,3452.28,35,8,2022,Personal Sale
2022-08-30,3000.0,0.0,452.28,35,8,2022,Housing
2022-08-30,91.25,0.0,361.03,35,8,2022,Shopping
2022-08-30,91.25,0.0,269.78,35,8,2022,Bills
2022-08-31,0.0,1013.64,1283.42,35,8,2022,Salary
2022-08-31,2.0,0.0,1281.42,35,8,2022,Entertainment
2022-09-01,40.0,0.0,1241.42,35,9,2022,Bills
2022-09-01,10.72,0.0,1230.7,35,9,2022,Transportation
2022-09-01,11.29,0.0,1219.41,35,9,2022,Groceries
2022-09-01,3.94,0.0,1215.47,35,9,2022,Transportation
2022-09-01,200.0,0.0,1015.47,35,9,2022,Shopping
2022-09-06,0.0,91.25,1106.72,36,9,2022,Interest
2022-09-06,11.73,0.0,1094.99,36,9,2022,Loan Payment
2022-09-06,12.23,0.0,1082.76,36,9,2022,Groceries
2022-09-06,15.95,0.0,1066.81,36,9,2022,Transportation
2022-09-07,28.0,0.0,1038.81,36,9,2022,Dining Out
2022-09-08,33.88,0.0,1004.93,36,9,2022,Shopping
2022-09-08,23.35,0.0,981.58,36,9,2022,Loan Payment
2022-09-08,5.87,0.0,975.71,36,9,2022,Groceries
2022-09-08,21.66,0.0,954.05,36,9,2022,Dining Out
2022-09-09,11.29,0.0,942.76,36,9,2022,Loan Payment
2022-09-09,27.6,0.0,915.16,36,9,2022,Bills
2022-09-12,22.8,0.0,892.36,37,9,2022,Entertainment
2022-09-12,1.9,0.0,890.46,37,9,2022,Loan Payment
2022-09-12,41.72,0.0,848.74,37,9,2022,Shopping
2022-09-12,45.4,0.0,803.34,37,9,2022,Housing
2022-09-12,31.9,0.0,771.44,37,9,2022,Transportation
2022-09-12,3.26,0.0,768.18,37,9,2022,Entertainment
2022-09-12,38.64,0.0,729.54,37,9,2022,Groceries
2022-09-12,17.68,0.0,711.86,37,9,2022,Groceries
2022-09-12,1.25,0.0,710.61,37,9,2022,Entertainment
2022-09-12,112.5,0.0,598.11,37,9,2022,Loan Payment
2022-09-12,34.34,0.0,563.77,37,9,2022,Dining Out
2022-09-12,20.84,0.0,542.93,37,9,2022,Loan Payment
2022-09-12,10.33,0.0,532.6,37,9,2022,Housing
2022-09-13,0.51,0.0,532.09,37,9,2022,Entertainment
2022-09-13,5.87,0.0,526.22,37,9,2022,Bills
2022-09-13,24.05,0.0,502.17,37,9,2022,Groceries
2022-09-13,30.24,0.0,471.93,37,9,2022,Housing
2022-09-14,7.76,0.0,464.17,37,9,2022,Loan Payment
2022-09-14,0.0,900.54,1364.71,37,9,2022,Salary
2022-09-14,141.65,0.0,1223.06,37,9,2022,Groceries
2022-09-14,20.5,0.0,1202.56,37,9,2022,Groceries
2022-09-14,21.71,0.0,1180.85,37,9,2022,Loan Payment
2022-09-15,24.05,0.0,1156.8,37,9,2022,Housing
2022-09-15,300.0,0.0,856.8,37,9,2022,Groceries
2022-09-16,22.6,0.0,834.2,37,9,2022,Entertainment
2022-09-16,50.91,0.0,783.29,37,9,2022,Groceries
2022-09-19,41.41,0.0,741.88,38,9,2022,Housing
2022-09-19,5.99,0.0,735.89,38,9,2022,Housing
2022-09-19,20.5,0.0,715.39,38,9,2022,Housing
2022-09-19,7.99,0.0,707.4,38,9,2022,Transportation
2022-09-19,20.5,0.0,686.9,38,9,2022,Transportation
2022-09-19,2.36,0.0,684.54,38,9,2022,Loan Payment
2022-09-19,18.0,0.0,666.54,38,9,2022,Loan Payment
2022-09-19,14.95,0.0,651.59,38,9,2022,Loan Payment
2022-09-20,25.45,0.0,626.14,38,9,2022,Transportation
2022-09-20,24.78,0.0,601.36,38,9,2022,Shopping
2022-09-20,17.05,0.0,584.31,38,9,2022,Bills
2022-09-21,21.16,0.0,563.15,38,9,2022,Entertainment
2022-09-22,18.9,0.0,544.25,38,9,2022,Bills
2022-09-22,5.63,0.0,538.62,38,9,2022,Entertainment
2022-09-23,3.82,0.0,534.8,38,9,2022,Entertainment
2022-09-23,20.82,0.0,513.98,38,9,2022,Shopping
2022-09-23,9.38,0.0,504.6,38,9,2022,Groceries
2022-09-23,2.65,0.0,501.95,38,9,2022,Bills
2022-09-26,24.05,0.0,477.9,39,9,2022,Shopping
2022-09-26,24.5,0.0,453.4,39,9,2022,Bills
2022-09-26,44.0,0.0,409.4,39,9,2022,Entertainment
2022-09-26,33.88,0.0,375.52,39,9,2022,Housing
2022-09-26,16.6,0.0,358.92,39,9,2022,Bills
2022-09-26,14.95,0.0,343.97,39,9,2022,Shopping
2022-09-26,11.06,0.0,332.91,39,9,2022,Shopping
2022-09-26,1.7,0.0,331.21,39,9,2022,Housing
2022-09-26,18.17,0.0,313.04,39,9,2022,Dining Out
2022-09-26,14.95,0.0,298.09,39,9,2022,Bills
2022-09-26,47.05,0.0,251.04,39,9,2022,Loan Payment
2022-09-26,0.0,47.05,298.09,39,9,2022,Bonus
2022-09-27,13.55,0.0,284.54,39,9,2022,Dining Out
2022-09-27,14.0,0.0,270.54,39,9,2022,Loan Payment
2022-09-28,0.0,517.34,787.88,39,9,2022,Personal Sale
2022-09-29,22.71,0.0,765.17,39,9,2022,Dining Out
2022-09-29,18.9,0.0,746.27,39,9,2022,Loan Payment
2022-09-29,0.0,0.01,746.28,39,9,2022,Personal Sale
2022-10-03,24.05,0.0,722.23,40,10,2022,Entertainment
2022-10-03,18.9,0.0,703.33,40,10,2022,Shopping
2022-10-03,20.6,0.0,682.73,40,10,2022,Loan Payment
2022-10-03,33.9,0.0,648.83,40,10,2022,Bills
2022-10-03,11.29,0.0,637.54,40,10,2022,Dining Out
2022-10-03,7.9,0.0,629.64,40,10,2022,Bills
2022-10-03,0.0,200.0,829.64,40,10,2022,Bonus
2022-10-03,249.7,0.0,579.94,40,10,2022,Loan Payment
2022-10-03,18.9,0.0,561.04,40,10,2022,Shopping
2022-10-03,48.0,0.0,513.04,40,10,2022,Dining Out
2022-10-03,14.5,0.0,498.54,40,10,2022,Shopping
2022-10-03,33.88,0.0,464.66,40,10,2022,Bills
2022-10-03,200.0,0.0,264.66,40,10,2022,Dining Out
2022-10-04,24.05,0.0,240.61,40,10,2022,Groceries
2022-10-06,16.92,0.0,223.69,40,10,2022,Loan Payment
2022-10-06,1.13,0.0,222.56,40,10,2022,Bills
2022-10-06,24.9,0.0,197.66,40,10,2022,Transportation
2022-10-06,44.04,0.0,153.62,40,10,2022,Shopping
2022-10-06,0.0,30.0,183.62,40,10,2022,Salary
2022-10-07,14.95,0.0,168.67,40,10,2022,Shopping
2022-10-07,10.72,0.0,157.95,40,10,2022,Shopping
2022-10-07,27.9,0.0,130.05,40,10,2022,Dining Out
2022-10-07,2.47,0.0,127.58,40,10,2022,Groceries
2022-10-11,36.0,0.0,91.58,41,10,2022,Housing
2022-10-11,5.0,0.0,86.58,41,10,2022,Shopping
2022-10-11,50.0,0.0,36.58,41,10,2022,Loan Payment
2022-10-12,0.0,593.67,630.25,41,10,2022,Personal Sale
2022-10-12,71.02,0.0,559.23,41,10,2022,Groceries
2022-10-12,23.95,0.0,535.28,41,10,2022,Bills
2022-10-13,75.0,0.0,460.28,41,10,2022,Dining Out
2022-10-14,7.63,0.0,452.65,41,10,2022,Bills
2022-10-14,11.85,0.0,440.8,41,10,2022,Dining Out
2022-10-14,100.0,0.0,340.8,41,10,2022,Entertainment
2022-10-17,55.94,0.0,284.86,42,10,2022,Groceries
2022-10-17,10.71,0.0,274.15,42,10,2022,Bills
2022-10-17,6.2,0.0,267.95,42,10,2022,Loan Payment
2022-10-18,30.48,0.0,237.47,42,10,2022,Bills
2022-10-18,33.88,0.0,203.59,42,10,2022,Bills
2022-10-19,27.21,0.0,176.38,42,10,2022,Dining Out
2022-10-19,15.25,0.0,161.13,42,10,2022,Bills
2022-10-20,28.87,0.0,132.26,42,10,2022,Loan Payment
2022-10-20,7.9,0.0,124.36,42,10,2022,Loan Payment
2022-10-20,0.0,150.0,274.36,42,10,2022,Salary
2022-10-20,6.99,0.0,267.37,42,10,2022,Housing
2022-10-20,22.05,0.0,245.32,42,10,2022,Shopping
2022-10-20,96.01,0.0,149.31,42,10,2022,Dining Out
2022-10-21,14.95,0.0,134.36,42,10,2022,Loan Payment
2022-10-21,8.57,0.0,125.79,42,10,2022,Shopping
2022-10-21,18.06,0.0,107.73,42,10,2022,Entertainment
2022-10-21,27.04,0.0,80.69,42,10,2022,Housing
2022-10-24,16.45,0.0,64.24,43,10,2022,Dining Out
2022-10-24,12.42,0.0,51.82,43,10,2022,Transportation
2022-10-24,8.78,0.0,43.04,43,10,2022,Bills
2022-10-24,19.9,0.0,23.14,43,10,2022,Shopping
2022-10-24,7.9,0.0,15.24,43,10,2022,Transportation
2022-10-24,11.95,0.0,3.29,43,10,2022,Groceries
2022-10-25,0.0,25.0,28.29,43,10,2022,Interest
2022-10-25,24.05,0.0,4.24,43,10,2022,Groceries
2022-10-25,0.0,20.0,24.24,43,10,2022,Return on Investement
2022-10-25,24.05,0.0,0.19,43,10,2022,Housing
2022-10-26,0.0,593.67,593.86,43,10,2022,Interest
2022-10-26,0.56,0.0,593.3,43,10,2022,Bills
2022-10-26,27.11,0.0,566.19,43,10,2022,Dining Out
2022-10-26,12.87,0.0,553.32,43,10,2022,Housing
2022-10-27,9.35,0.0,543.97,43,10,2022,Housing
2022-10-27,16.95,0.0,527.02,43,10,2022,Housing
2022-10-28,20.34,0.0,506.68,43,10,2022,Entertainment
2022-10-28,2.63,0.0,504.05,43,10,2022,Entertainment
2022-10-28,16.95,0.0,487.1,43,10,2022,Bills
2022-10-31,24.9,0.0,462.2,44,10,2022,Groceries
2022-10-31,17.25,0.0,444.95,44,10,2022,Transportation
2022-10-31,17.95,0.0,427.0,44,10,2022,Bills
2022-10-31,16.95,0.0,410.05,44,10,2022,Bills
2022-10-31,11.85,0.0,398.2,44,10,2022,Transportation
2022-10-31,27.11,0.0,371.09,44,10,2022,Entertainment
2022-10-31,12.87,0.0,358.22,44,10,2022,Groceries
2022-10-31,7.9,0.0,350.32,44,10,2022,Groceries
2022-10-31,2.9,0.0,347.42,44,10,2022,Entertainment
2022-10-31,0.0,80.0,427.42,44,10,2022,Bonus
2022-10-31,80.0,0.0,347.42,44,10,2022,Transportation
2022-11-01,3.4,0.0,344.02,44,11,2022,Shopping
2022-11-01,21.75,0.0,322.27,44,11,2022,Shopping
2022-11-01,6.77,0.0,315.5,44,11,2022,Transportation
2022-11-02,18.6,0.0,296.9,44,11,2022,Transportation
2022-11-02,23.67,0.0,273.23,44,11,2022,Bills
2022-11-03,14.68,0.0,258.55,44,11,2022,Loan Payment
2022-11-03,14.95,0.0,243.6,44,11,2022,Shopping
2022-11-03,8.69,0.0,234.91,44,11,2022,Dining Out
2022-11-07,33.87,0.0,201.04,45,11,2022,Housing
2022-11-07,55.96,0.0,145.08,45,11,2022,Housing
2022-11-07,16.95,0.0,128.13,45,11,2022,Dining Out
2022-11-07,15.75,0.0,112.38,45,11,2022,Groceries
2022-11-07,12.42,0.0,99.96,45,11,2022,Groceries
2022-11-07,21.21,0.0,78.75,45,11,2022,Housing
2022-11-07,12.87,0.0,65.88,45,11,2022,Housing
2022-11-08,2.09,0.0,63.79,45,11,2022,Entertainment
2022-11-08,22.59,0.0,41.2,45,11,2022,Dining Out
2022-11-08,16.95,0.0,24.25,45,11,2022,Housing
2022-11-09,0.0,358.55,382.8,45,11,2022,Bonus
2022-11-09,27.21,0.0,355.59,45,11,2022,Shopping
2022-11-09,25.58,0.0,330.01,45,11,2022,Bills
2022-11-09,35.86,0.0,294.15,45,11,2022,Shopping
2022-11-10,24.05,0.0,270.1,45,11,2022,Groceries
2022-11-14,61.79,0.0,208.31,46,11,2022,Entertainment
2022-11-14,103.9,0.0,104.41,46,11,2022,Shopping
2022-11-14,29.95,0.0,74.46,46,11,2022,Groceries
2022-11-14,26.4,0.0,48.06,46,11,2022,Bills
2022-11-14,18.5,0.0,29.56,46,11,2022,Transportation
2022-11-14,16.0,0.0,13.56,46,11,2022,Shopping
2022-11-14,0.0,100.0,113.56,46,11,2022,Salary
2022-11-14,27.11,0.0,86.45,46,11,2022,Bills
2022-11-14,0.0,200.0,286.45,46,11,2022,Personal Sale
2022-11-15,100.05,0.0,186.4,46,11,2022,Transportation
2022-11-16,22.6,0.0,163.8,46,11,2022,Loan Payment
2022-11-16,17.05,0.0,146.75,46,11,2022,Housing
2022-11-16,60.0,0.0,86.75,46,11,2022,Entertainment
2022-11-17,16.68,0.0,70.07,46,11,2022,Transportation
2022-11-17,9.82,0.0,60.25,46,11,2022,Shopping
2022-11-18,1.0,0.0,59.25,46,11,2022,Entertainment
2022-11-18,30.0,0.0,29.25,46,11,2022,Entertainment
2022-11-21,0.0,60.0,89.25,47,11,2022,Personal Sale
2022-11-21,30.0,0.0,59.25,47,11,2022,Bills
2022-11-21,22.01,0.0,37.24,47,11,2022,Bills
2022-11-21,18.05,0.0,19.19,47,11,2022,Entertainment
2022-11-21,0.0,50.0,69.19,47,11,2022,Bonus
2022-11-21,18.5,0.0,50.69,47,11,2022,Transportation
2022-11-21,8.35,0.0,42.34,47,11,2022,Bills
2022-11-21,5.97,0.0,36.37,47,11,2022,Loan Payment
2022-11-21,2.9,0.0,33.47,47,11,2022,Housing
2022-11-21,24.05,0.0,9.42,47,11,2022,Shopping
2022-11-22,2.9,0.0,6.52,47,11,2022,Loan Payment
2022-11-22,3.4,0.0,3.12,47,11,2022,Transportation
2022-11-22,0.0,60.0,63.12,47,11,2022,Personal Sale
2022-11-22,3.0,0.0,60.12,47,11,2022,Groceries
2022-11-22,15.4,0.0,44.72,47,11,2022,Loan Payment
2022-11-22,5.54,0.0,39.18,47,11,2022,Housing
2022-11-22,12.98,0.0,26.2,47,11,2022,Shopping
2022-11-22,10.78,0.0,15.42,47,11,2022,Shopping
2022-11-22,2.42,0.0,13.0,47,11,2022,Housing
2022-11-23,0.0,350.66,363.66,47,11,2022,Personal Sale
2022-11-23,38.39,0.0,325.27,47,11,2022,Bills
2022-11-23,20.34,0.0,304.93,47,11,2022,Transportation
2022-11-23,14.95,0.0,289.98,47,11,2022,Shopping
2022-11-23,33.88,0.0,256.1,47,11,2022,Bills
2022-11-24,0.0,2123.93,2380.03,47,11,2022,Interest
2022-11-24,150.0,0.0,2230.03,47,11,2022,Dining Out
2022-11-24,30.6,0.0,2199.43,47,11,2022,Groceries
2022-11-25,16.34,0.0,2183.09,47,11,2022,Entertainment
2022-11-25,20.6,0.0,2162.49,47,11,2022,Shopping
2022-11-25,39.94,0.0,2122.55,47,11,2022,Housing
2022-11-25,1000.0,0.0,1122.55,47,11,2022,Housing
2022-11-28,134.1,0.0,988.45,48,11,2022,Transportation
2022-11-28,18.5,0.0,969.95,48,11,2022,Dining Out
2022-11-28,96.01,0.0,873.94,48,11,2022,Shopping
2022-11-28,24.05,0.0,849.89,48,11,2022,Loan Payment
2022-11-28,113.83,0.0,736.06,48,11,2022,Bills
2022-11-28,10.7,0.0,725.36,48,11,2022,Housing
2022-11-28,600.0,0.0,125.36,48,11,2022,Transportation
2022-11-29,22.6,0.0,102.76,48,11,2022,Groceries
2022-11-30,21.32,0.0,81.44,48,11,2022,Transportation
2022-11-30,27.0,0.0,54.44,48,11,2022,Housing
2022-12-01,12.51,0.0,41.93,48,12,2022,Housing
2022-12-01,0.0,100.0,141.93,48,12,2022,Bonus
2022-12-01,33.9,0.0,108.03,48,12,2022,Transportation
2022-12-01,26.56,0.0,81.47,48,12,2022,Entertainment
2022-12-05,29.31,0.0,52.16,49,12,2022,Housing
2022-12-05,19.05,0.0,33.11,49,12,2022,Loan Payment
2022-12-05,25.0,0.0,8.11,49,12,2022,Loan Payment
2022-12-05,0.0,50.0,58.11,49,12,2022,Personal Sale
2022-12-05,12.87,0.0,45.24,49,12,2022,Loan Payment
2022-12-07,0.0,593.67,638.91,49,12,2022,Salary
2022-12-07,27.92,0.0,610.99,49,12,2022,Shopping
2022-12-07,115.97,0.0,495.02,49,12,2022,Dining Out
2022-12-07,18.14,0.0,476.88,49,12,2022,Loan Payment
2022-12-07,50.3,0.0,426.58,49,12,2022,Dining Out
2022-12-07,40.66,0.0,385.92,49,12,2022,Entertainment
2022-12-09,30.24,0.0,355.68,49,12,2022,Housing
2022-12-09,0.0,1.0,356.68,49,12,2022,Salary
2022-12-12,8.19,0.0,348.49,50,12,2022,Loan Payment
2022-12-12,48.59,0.0,299.9,50,12,2022,Bills
2022-12-12,34.0,0.0,265.9,50,12,2022,Housing
2022-12-12,7.67,0.0,258.23,50,12,2022,Dining Out
2022-12-13,27.66,0.0,230.57,50,12,2022,Entertainment
2022-12-14,18.45,0.0,212.12,50,12,2022,Entertainment
2022-12-14,24.05,0.0,188.07,50,12,2022,Loan Payment
2022-12-15,26.05,0.0,162.02,50,12,2022,Housing
2022-12-16,25.0,0.0,137.02,50,12,2022,Shopping
2022-12-16,0.0,80.0,217.02,50,12,2022,Personal Sale
2022-12-19,151.08,0.0,65.94,51,12,2022,Transportation
2022-12-19,10.14,0.0,55.8,51,12,2022,Entertainment
2022-12-19,0.0,55.0,110.8,51,12,2022,Return on Investement
2022-12-19,29.31,0.0,81.49,51,12,2022,Dining Out
2022-12-19,50.3,0.0,31.19,51,12,2022,Shopping
2022-12-19,1.2,0.0,29.99,51,12,2022,Entertainment
2022-12-19,27.11,0.0,2.88,51,12,2022,Groceries
2022-12-20,0.0,40.0,42.88,51,12,2022,Bonus
2022-12-20,27.6,0.0,15.28,51,12,2022,Entertainment
2022-12-21,0.0,116.35,131.63,51,12,2022,Personal Sale
2022-12-21,0.0,484.06,615.69,51,12,2022,Interest
2022-12-21,25.7,0.0,589.99,51,12,2022,Transportation
2022-12-21,18.05,0.0,571.94,51,12,2022,Groceries
2022-12-22,25.15,0.0,546.79,51,12,2022,Transportation
2022-12-22,14.68,0.0,532.11,51,12,2022,Loan Payment
2022-12-23,55.0,0.0,477.11,51,12,2022,Dining Out
2022-12-28,27.09,0.0,450.02,52,12,2022,Transportation
2022-12-28,16.1,0.0,433.92,52,12,2022,Transportation
2022-12-28,201.14,0.0,232.78,52,12,2022,Bills
2022-12-28,16.1,0.0,216.68,52,12,2022,Entertainment
2022-12-28,16.1,0.0,200.58,52,12,2022,Groceries
2022-12-29,16.1,0.0,184.48,52,12,2022,Transportation
2022-12-30,16.1,0.0,168.38,52,12,2022,Groceries
2023-01-03,16.1,0.0,152.28,1,1,2023,Entertainment
2023-01-03,14.23,0.0,138.05,1,1,2023,Shopping
2023-01-03,19.05,0.0,119.0,1,1,2023,Loan Payment
2023-01-03,111.22,0.0,7.78,1,1,2023,Groceries
2023-01-03,0.0,50.0,57.78,1,1,2023,Personal Sale
2023-01-03,31.63,0.0,26.15,1,1,2023,Bills
2023-01-03,0.0,73.0,99.15,1,1,2023,Personal Sale
2023-01-03,13.5,0.0,85.65,1,1,2023,Loan Payment
2023-01-03,0.0,100.0,185.65,1,1,2023,Bonus
2023-01-03,96.01,0.0,89.64,1,1,2023,Dining Out
2023-01-03,0.0,20.0,109.64,1,1,2023,Salary
2023-01-04,99.92,0.0,9.72,1,1,2023,Transportation
2023-01-04,0.0,272.98,282.7,1,1,2023,Return on Investement
2023-01-06,2.9,0.0,279.8,1,1,2023,Housing
2023-01-09,30.5,0.0,249.3,2,1,2023,Dining Out
2023-01-09,20.33,0.0,228.97,2,1,2023,Shopping
2023-01-09,0.0,3000.0,3228.97,2,1,2023,Interest
2023-01-09,2900.0,0.0,328.97,2,1,2023,Loan Payment
2023-01-09,10.7,0.0,318.27,2,1,2023,Housing
2023-01-09,9.2,0.0,309.07,2,1,2023,Dining Out
2023-01-10,0.0,2200.0,2509.07,2,1,2023,Interest
2023-01-10,2200.0,0.0,309.07,2,1,2023,Shopping
2023-01-10,30.86,0.0,278.21,2,1,2023,Housing
2023-01-10,74.88,0.0,203.33,2,1,2023,Groceries
2023-01-10,18.9,0.0,184.43,2,1,2023,Shopping
2023-01-11,27.46,0.0,156.97,2,1,2023,Transportation
2023-01-11,11.95,0.0,145.02,2,1,2023,Bills
2023-01-12,4.0,0.0,141.02,2,1,2023,Entertainment
2023-01-12,18.5,0.0,122.52,2,1,2023,Loan Payment
2023-01-12,19.75,0.0,102.77,2,1,2023,Loan Payment
2023-01-13,0.0,100.0,202.77,2,1,2023,Bonus
2023-01-13,105.38,0.0,97.39,2,1,2023,Dining Out
2023-01-13,27.05,0.0,70.34,2,1,2023,Dining Out
2023-01-16,27.05,0.0,43.29,3,1,2023,Dining Out
2023-01-16,0.0,80.0,123.29,3,1,2023,Personal Sale
2023-01-16,22.05,0.0,101.24,3,1,2023,Dining Out
2023-01-16,14.55,0.0,86.69,3,1,2023,Shopping
2023-01-16,79.08,0.0,7.61,3,1,2023,Transportation
2023-01-16,1.0,0.0,6.61,3,1,2023,Transportation
2023-01-17,1.0,0.0,5.61,3,1,2023,Transportation
2023-01-17,0.0,30.0,35.61,3,1,2023,Interest
2023-01-17,6.2,0.0,29.41,3,1,2023,Entertainment
2023-01-17,27.6,0.0,1.81,3,1,2023,Entertainment
2023-01-18,0.0,235.99,237.8,3,1,2023,Bonus
2023-01-18,27.6,0.0,210.2,3,1,2023,Transportation
2023-01-19,20.5,0.0,189.7,3,1,2023,Housing
2023-01-19,22.01,0.0,167.69,3,1,2023,Transportation
2023-01-20,17.23,0.0,150.46,3,1,2023,Dining Out
2023-01-20,33.86,0.0,116.6,3,1,2023,Housing
2023-01-20,0.0,15.0,131.6,3,1,2023,Return on Investement
2023-01-20,48.1,0.0,83.5,3,1,2023,Transportation
2023-01-20,29.14,0.0,54.36,3,1,2023,Bills
2023-01-23,27.11,0.0,27.25,4,1,2023,Groceries
2023-01-23,24.6,0.0,2.65,4,1,2023,Entertainment
2023-01-23,0.0,100.0,102.65,4,1,2023,Personal Sale
2023-01-23,84.63,0.0,18.02,4,1,2023,Shopping
2023-01-23,0.0,50.0,68.02,4,1,2023,Interest
2023-01-23,30.6,0.0,37.42,4,1,2023,Shopping
2023-01-24,6.2,0.0,31.22,4,1,2023,Groceries
2023-01-24,2.9,0.0,28.32,4,1,2023,Groceries
2023-01-25,1.9,0.0,26.42,4,1,2023,Shopping
2023-01-25,1.9,0.0,24.52,4,1,2023,Shopping
2023-01-25,23.15,0.0,1.37,4,1,2023,Loan Payment
2023-01-26,0.0,50.0,51.37,4,1,2023,Personal Sale
2023-01-26,19.39,0.0,31.98,4,1,2023,Groceries
2023-01-27,22.85,0.0,9.13,4,1,2023,Loan Payment
2023-01-27,0.0,30.0,39.13,4,1,2023,Personal Sale
2023-01-30,25.74,0.0,13.39,5,1,2023,Shopping
2023-01-30,0.0,40.0,53.39,5,1,2023,Interest
2023-01-30,41.29,0.0,12.1,5,1,2023,Shopping
2023-01-30,0.0,25.0,37.1,5,1,2023,Salary
2023-01-30,23.25,0.0,13.85,5,1,2023,Housing
2023-01-30,9.6,0.0,4.25,5,1,2023,Transportation
2023-01-30,0.0,75.0,79.25,5,1,2023,Personal Sale
2023-01-30,32.44,0.0,46.81,5,1,2023,Bills
2023-01-30,2.8,0.0,44.01,5,1,2023,Transportation
2023-01-30,15.93,0.0,28.08,5,1,2023,Loan Payment
2023-01-30,8.69,0.0,19.39,5,1,2023,Transportation
2023-01-30,1.46,0.0,17.93,5,1,2023,Loan Payment
2023-01-31,9.35,0.0,8.58,5,1,2023,Transportation
2023-01-31,0.0,50.0,58.58,5,1,2023,Return on Investement
2023-01-31,20.1,0.0,38.48,5,1,2023,Transportation
2023-01-31,24.39,0.0,14.09,5,1,2023,Loan Payment
2023-01-31,0.0,20.0,34.09,5,1,2023,Bonus
2023-01-31,16.79,0.0,17.3,5,1,2023,Loan Payment
